AAAAATTGAGA -> AAAATTGAGAC
AAAACCGGTTA -> AAACCGGTTAA
AAAATGAAGCA -> AAATGAAGCAC
AAAATTCATAA -> AAATTCATAAG
AAAATTGAGAC -> AAATTGAGACG
AAACACTTAAT -> AACACTTAATG
AAACAGGATCC -> AACAGGATCCC
AAACATTCTAG -> AACATTCTAGA
AAACCCGAGAG -> AACCCGAGAGA
AAACCGCCTTT -> AACCGCCTTTA
AAACCGCTTAC -> AACCGCTTACT
AAACCGGTTAA -> AACCGGTTAAG
AAACTGCCGGA -> AACTGCCGGAC
AAAGAGTCAAG -> AAGAGTCAAGT
AAAGTTCAAAC -> AAGTTCAAACC
AAAGTTGGATC -> AAGTTGGATCA
AAATACAGCCG -> AATACAGCCGT
AAATATAACTC -> AATATAACTCG
AAATATATCCT -> AATATATCCTC
AAATATTATGG -> AATATTATGGC
AAATGAACGGC -> AATGAACGGCA
AAATGAAGCAC -> AATGAAGCACA
AAATGATACTC -> AATGATACTCC
AAATGGTGGGA -> AATGGTGGGAT
AAATGGTTAAG -> AATGGTTAAGG
AAATTCATAAG -> AATTCATAAGA
AAATTGAGACG -> AATTGAGACGC
AACAACCTTAT -> ACAACCTTATG
AACACCCCCTG -> ACACCCCCTGA
AACACCTCAAC -> ACACCTCAACC
AACACTTAATG -> ACACTTAATGG
AACAGGATCCC -> ACAGGATCCCT
AACATAACGAG -> ACATAACGAGA
AACATTCTAGA -> ACATTCTAGAA
AACATTGTTAG -> ACATTGTTAGC
AACCAATACCG -> ACCAATACCGG
AACCAGGGTCA -> ACCAGGGTCAA
AACCCAATACA -> ACCCAATACAT
AACCCGAGAGA -> ACCCGAGAGAG
AACCCGAGTCC -> ACCCGAGTCCT
AACCGCCTTTA -> ACCGCCTTTAG
AACCGCTTACT -> ACCGCTTACTA
AACCGGTTAAG -> ACCGGTTAAGG
AACCGTCGGCC -> ACCGTCGGCCT
AACCTGTATTG -> ACCTGTATTGG
AACCTTATGAA -> ACCTTATGAAC
AACGACCTCGT -> ACGACCTCGTG
AACGAGACAAC -> ACGAGACAACT
AACGCATAGAT -> ACGCATAGATC
AACGGCAAACA -> ACGGCAAACAT
AACGGCCGTCC -> ACGGCCGTCCG
AACGTATAAGA -> ACGTATAAGAC
AACTAATAACG -> ACTAATAACGG
AACTATTTGGG -> ACTATTTGGGG
AACTCATAAAT -> ACTCATAAATA
AACTCCGGTCC -> ACTCCGGTCCC
AACTCCTTACT -> ACTCCTTACTG
AACTCGCGAGG -> ACTCGCGAGGG
AACTCGTAACG -> ACTCGTAACGT
AACTGCCCAAA -> ACTGCCCAAAA
AACTGCCGGAC -> ACTGCCGGACT
AACTTCCGTGG -> ACTTCCGTGGG
AAGAAGTGCCC -> AGAAGTGCCCG
AAGACATACTG -> AGACATACTGT
AAGACTATGTC -> AGACTATGTCA
AAGACTCGTCC -> AGACTCGTCCG
AAGACTGCCCA -> AGACTGCCCAG
AAGAGAGAGAC -> AGAGAGAGACA
AAGAGATGCCC -> AGAGATGCCCT
AAGAGTCAAGT -> AGAGTCAAGTT
AAGATGTAACC -> AGATGTAACCC
AAGCACAACAT -> AGCACAACATA
AAGCGCCACAC -> AGCGCCACACA
AAGCTTGGCCA -> AGCTTGGCCAA
AAGGACTATCG -> AGGACTATCGT
AAGGAGTCTCG -> AGGAGTCTCGG
AAGGATTGTGC -> AGGATTGTGCC
AAGGCTTGTAT -> AGGCTTGTATT
AAGGTTATGAC -> AGGTTATGACG
AAGTACGTTCC -> AGTACGTTCCG
AAGTGCAAAGA -> AGTGCAAAGAG
AAGTGCAATGC -> AGTGCAATGCA
AAGTGCAGGGT -> AGTGCAGGGTT
AAGTGCCCGGT -> AGTGCCCGGTT
AAGTTATTTGT -> AGTTATTTGTG
AAGTTCAAACC -> AGTTCAAACCG
AAGTTGATGGA -> AGTTGATGGAG
AAGTTGGATCA -> AGTTGGATCAC
AATAACGGCCG -> ATAACGGCCGT
AATAATGAGCG -> ATAATGAGCGG
AATACAGCCGT -> ATACAGCCGTA
AATACATCTTT -> ATACATCTTTT
AATACCGGGGC -> ATACCGGGGCC
AATATAACTCG -> ATATAACTCGT
AATATATCCTC -> ATATATCCTCT
AATATTATGGC -> ATATTATGGCG
AATATTTTGTT -> ATATTTTGTTC
AATCCTTGTTC -> ATCCTTGTTCA
AATGAACGGCA -> ATGAACGGCAA
AATGAAGCACA -> ATGAAGCACAA
AATGACCGGTC -> ATGACCGGTCT
AATGAGACTGT -> ATGAGACTGTC
AATGAGCGGGT -> ATGAGCGGGTT
AATGATACTCC -> ATGATACTCCT
AATGCAGTTTA -> ATGCAGTTTAT
AATGCCAGCAT -> ATGCCAGCATT
AATGGAACCCA -> ATGGAACCCAA
AATGGCACGTC -> ATGGCACGTCA
AATGGCTGCAC -> ATGGCTGCACG
AATGGTGGGAT -> ATGGTGGGATG
AATGGTTAAGG -> ATGGTTAAGGA
AATGTCAAGTG -> ATGTCAAGTGC
AATTAAGACTG -> ATTAAGACTGC
AATTAGCTAAG -> ATTAGCTAAGA
AATTATAGGAC -> ATTATAGGACA
AATTCATAAGA -> ATTCATAAGAA
AATTCCCCGTA -> ATTCCCCGTAG
AATTCGTGTTT -> ATTCGTGTTTC
AATTGAGACGC -> ATTGAGACGCG
AATTTAGAGAA -> ATTTAGAGAAT
AATTTTTCATC -> ATTTTTCATCC
ACAACATAACG -> CAACATAACGA
ACAACCGTCGG -> CAACCGTCGGC
ACAACCTTATG -> CAACCTTATGA
ACAACTCCTTA -> CAACTCCTTAC
ACAACTTCCGT -> CAACTTCCGTG
ACAAGTACGTT -> CAAGTACGTTC
ACAAGTTATTT -> CAAGTTATTTG
ACAATATTTTG -> CAATATTTTGT
ACAATGACCGG -> CAATGACCGGT
ACAATTCGTGT -> CAATTCGTGTT
ACACAATATTT -> CACAATATTTT
ACACACAATAT -> CACACAATATT
ACACATGAGCT -> CACATGAGCTG
ACACCCCCTGA -> CACCCCCTGAA
ACACCGGGAGC -> CACCGGGAGCG
ACACCTAAATG -> CACCTAAATGA
ACACCTCAACC -> CACCTCAACCA
ACACCTCCTTA -> CACCTCCTTAA
ACACGGCTGGG -> CACGGCTGGGC
ACACTCCTGTC -> CACTCCTGTCT
ACACTCCTTTC -> CACTCCTTTCG
ACACTTAATGG -> CACTTAATGGA
ACACTTATATG -> CACTTATATGT
ACACTTGAGGT -> CACTTGAGGTC
ACACTTTCGTC -> CACTTTCGTCA
ACAGATCCGCC -> CAGATCCGCCA
ACAGCCGTACA -> CAGCCGTACAC
ACAGGATACGC -> CAGGATACGCG
ACAGGATCCCT -> CAGGATCCCTT
ACAGGCATCGG -> CAGGCATCGGG
ACATAACGAGA -> CATAACGAGAC
ACATACTGTGT -> CATACTGTGTA
ACATCATGTCG -> CATCATGTCGG
ACATCCTGCGT -> CATCCTGCGTT
ACATCGCACCA -> CATCGCACCAA
ACATCGGGCTC -> CATCGGGCTCC
ACATCTAGCCC -> CATCTAGCCCA
ACATCTTTTTC -> CATCTTTTTCG
ACATGACACTC -> CATGACACTCC
ACATGAGCTGA -> CATGAGCTGAC
ACATTCCCGGG -> CATTCCCGGGG
ACATTCTAGAA -> CATTCTAGAAA
ACATTGTTAGC -> CATTGTTAGCC
ACCAACTAATA -> CCAACTAATAA
ACCAATACCGG -> CCAATACCGGG
ACCAGAGAGAC -> CCAGAGAGACG
ACCAGGGTACG -> CCAGGGTACGA
ACCAGGGTCAA -> CCAGGGTCAAT
ACCATTGTCAA -> CCATTGTCAAC
ACCCAATACAT -> CCCAATACATC
ACCCACTGCAC -> CCCACTGCACA
ACCCCCTGAAA -> CCCCCTGAAAC
ACCCGAGAGAG -> CCCGAGAGAGA
ACCCGAGTCCT -> CCCGAGTCCTC
ACCCTACAAGT -> CCCTACAAGTT
ACCCTACATCC -> CCCTACATCCT
ACCGCCTTTAG -> CCGCCTTTAGG
ACCGCTTACTA -> CCGCTTACTAG
ACCGGGAGCGG -> CCGGGAGCGGC
ACCGGGGCCAT -> CCGGGGCCATG
ACCGGTCTTCT -> CCGGTCTTCTC
ACCGGTTAAGG -> CCGGTTAAGGC
ACCGTCCTGAC -> CCGTCCTGACC
ACCGTCGGCCT -> CCGTCGGCCTG
ACCTAAATGAT -> CCTAAATGATA
ACCTAACGACC -> CCTAACGACCT
ACCTCAACCAA -> CCTCAACCAAT
ACCTCCTTAAC -> CCTCCTTAACA
ACCTCGCTTCA -> CCTCGCTTCAG
ACCTCGGATCC -> CCTCGGATCCG
ACCTCGTGCGA -> CCTCGTGCGAT
ACCTGATAGTC -> CCTGATAGTCT
ACCTGCGCCCA -> CCTGCGCCCAT
ACCTGTATTGG -> CCTGTATTGGG
ACCTTATGAAC -> CCTTATGAACT
ACGACAACCGT -> CGACAACCGTC
ACGACACCGGG -> CGACACCGGGA
ACGACCTCGTG -> CGACCTCGTGC
ACGACGTCGAA -> CGACGTCGAAG
ACGAGACAACT -> CGAGACAACTT
ACGAGGGGGTG -> CGAGGGGGTGC
ACGCAGATCCC -> CGCAGATCCCA
ACGCATAGATC -> CGCATAGATCG
ACGCCTAGTCC -> CGCCTAGTCCT
ACGCGAGCGAG -> CGCGAGCGAGA
ACGCGATCTGC -> CGCGATCTGCT
ACGCTGAGTAA -> CGCTGAGTAAC
ACGGAAGTGCA -> CGGAAGTGCAA
ACGGCAAACAT -> CGGCAAACATT
ACGGCCGTCCG -> CGGCCGTCCGC
ACGGCCTCGAA -> CGGCCTCGAAA
ACGGCTGGGCA -> CGGCTGGGCAT
ACGGGAGCAGC -> CGGGAGCAGCA
ACGTAAACCGC -> CGTAAACCGCT
ACGTATAAGAC -> CGTATAAGACA
ACGTCACTAGT -> CGTCACTAGTG
ACGTCGAAGTG -> CGTCGAAGTGC
ACGTGAGCAGG -> CGTGAGCAGGT
ACGTTCCGTGA -> CGTTCCGTGAC
ACGTTCGTATC -> CGTTCGTATCT
ACTAATAACGG -> CTAATAACGGC
ACTAGCAAAAA -> CTAGCAAAAAT
ACTAGCCGGTG -> CTAGCCGGTGA
ACTAGTGGATA -> CTAGTGGATAG
ACTATCGTGAC -> CTATCGTGACG
ACTATGGTCGT -> CTATGGTCGTA
ACTATGTCACG -> CTATGTCACGT
ACTATTTGGGG -> CTATTTGGGGT
ACTCAGCCGCC -> CTCAGCCGCCA
ACTCATAAATA -> CTCATAAATAC
ACTCCGGTCCC -> CTCCGGTCCCC
ACTCCTACAAT -> CTCCTACAATG
ACTCCTGTCTG -> CTCCTGTCTGT
ACTCCTTACTG -> CTCCTTACTGA
ACTCCTTTCGC -> CTCCTTTCGCG
ACTCGCGAGGG -> CTCGCGAGGGA
ACTCGTAACGT -> CTCGTAACGTA
ACTCGTCCGCT -> CTCGTCCGCTC
ACTGAAGAGAT -> CTGAAGAGATG
ACTGCACACCT -> CTGCACACCTC
ACTGCCCAAAA -> CTGCCCAAAAC
ACTGCCCAGGT -> CTGCCCAGGTG
ACTGCCGGACT -> CTGCCGGACTG
ACTGCCTTTAA -> CTGCCTTTAAG
ACTGTAGACCA -> CTGTAGACCAG
ACTGTCCGTAG -> CTGTCCGTAGA
ACTGTGACAGA -> CTGTGACAGAT
ACTGTGTAAGG -> CTGTGTAAGGT
ACTTAATGGAA -> CTTAATGGAAC
ACTTATATGTT -> CTTATATGTTG
ACTTCAGGTGG -> CTTCAGGTGGA
ACTTCCGTGGG -> CTTCCGTGGGT
ACTTGAGGTCA -> CTTGAGGTCAA
ACTTGGACGGA -> CTTGGACGGAA
ACTTTCGTCAG -> CTTTCGTCAGG
AGAAAATGAAG -> GAAAATGAAGC
AGAAACACTTA -> GAAACACTTAA
AGAAGTGCCCG -> GAAGTGCCCGG
AGAATTAAGAC -> GAATTAAGACT
AGAATTAGCTA -> GAATTAGCTAA
AGACAACTTCC -> GACAACTTCCG
AGACACCTAAA -> GACACCTAAAT
AGACACGGCTG -> GACACGGCTGG
AGACATACTGT -> GACATACTGTG
AGACCAGAGAG -> GACCAGAGAGA
AGACGCGATCT -> GACGCGATCTG
AGACGTTCGTA -> GACGTTCGTAT
AGACTATGTCA -> GACTATGTCAC
AGACTCAGCCG -> GACTCAGCCGC
AGACTCGTCCG -> GACTCGTCCGC
AGACTGCCCAG -> GACTGCCCAGG
AGACTGTCCGT -> GACTGTCCGTA
AGAGAATTAAG -> GAGAATTAAGA
AGAGACACCTA -> GAGACACCTAA
AGAGACGTTCG -> GAGACGTTCGT
AGAGAGACACC -> GAGAGACACCT
AGAGAGACGTT -> GAGAGACGTTC
AGAGAGAGACA -> GAGAGAGACAC
AGAGAGAGCGA -> GAGAGAGCGAT
AGAGAGCGATC -> GAGAGCGATCA
AGAGATGCCCT -> GAGATGCCCTG
AGAGCGATCAC -> GAGCGATCACC
AGAGGGACCCT -> GAGGGACCCTA
AGAGTCAAGTT -> GAGTCAAGTTG
AGAGTCGTCCA -> GAGTCGTCCAA
AGAGTGACTAT -> GAGTGACTATG
AGATCCCAGGT -> GATCCCAGGTG
AGATCCGCCAT -> GATCCGCCATC
AGATCGCAACT -> GATCGCAACTC
AGATCGCAATT -> GATCGCAATTC
AGATCGGTATC -> GATCGGTATCA
AGATGCCCTGG -> GATGCCCTGGC
AGATGTAACCC -> GATGTAACCCG
AGCAAAAATTG -> GCAAAAATTGA
AGCACAACATA -> GCACAACATAA
AGCAGACTCAG -> GCAGACTCAGC
AGCAGCATATT -> GCAGCATATTT
AGCAGGTGATC -> GCAGGTGATCT
AGCATATTTGC -> GCATATTTGCC
AGCATTCCCCT -> GCATTCCCCTC
AGCATTGCCAC -> GCATTGCCACC
AGCCAAACAGG -> GCCAAACAGGA
AGCCCAGCCGA -> GCCCAGCCGAT
AGCCGATTGAC -> GCCGATTGACA
AGCCGCCACTT -> GCCGCCACTTG
AGCCGGTGAAG -> GCCGGTGAAGC
AGCCGTACACT -> GCCGTACACTT
AGCGAGACACG -> GCGAGACACGG
AGCGATCACCT -> GCGATCACCTC
AGCGCCACACA -> GCGCCACACAC
AGCGCGTTCTA -> GCGCGTTCTAT
AGCGGCTAGTG -> GCGGCTAGTGC
AGCGGGTTAAA -> GCGGGTTAAAT
AGCTAAGATGT -> GCTAAGATGTA
AGCTAGCTTAC -> GCTAGCTTACC
AGCTGACTAGC -> GCTGACTAGCA
AGCTGAGGCCA -> GCTGAGGCCAG
AGCTTACCTCG -> GCTTACCTCGG
AGCTTGGCCAA -> GCTTGGCCAAT
AGGAAAGTTCA -> GGAAAGTTCAA
AGGAAAGTTGG -> GGAAAGTTGGA
AGGACATCATG -> GGACATCATGT
AGGACTATCGT -> GGACTATCGTG
AGGAGTCTCGG -> GGAGTCTCGGG
AGGATACGCGA -> GGATACGCGAG
AGGATCCCTTA -> GGATCCCTTAC
AGGATTGTGCC -> GGATTGTGCCA
AGGCATCGGGA -> GGCATCGGGAA
AGGCATGATTG -> GGCATGATTGT
AGGCATTTACG -> GGCATTTACGC
AGGCCAGTTCA -> GGCCAGTTCAC
AGGCTAATAAT -> GGCTAATAATG
AGGCTTACGGC -> GGCTTACGGCC
AGGCTTGTATT -> GGCTTGTATTC
AGGGACCCTAC -> GGGACCCTACA
AGGGATAATGC -> GGGATAATGCC
AGGGCCTTGAC -> GGGCCTTGACA
AGGGCTACCGT -> GGGCTACCGTC
AGGGGGTGCTA -> GGGGGTGCTAG
AGGGTACGACA -> GGGTACGACAA
AGGGTCAATGG -> GGGTCAATGGC
AGGGTTATCAA -> GGGTTATCAAA
AGGGTTCATCA -> GGGTTCATCAT
AGGTCAACTGC -> GGTCAACTGCC
AGGTGATCTAC -> GGTGATCTACC
AGGTGGATGTA -> GGTGGATGTAA
AGGTGTGTACC -> GGTGTGTACCT
AGGTGTTACGA -> GGTGTTACGAC
AGGTTATGACG -> GGTTATGACGA
AGTAACCTGTA -> GTAACCTGTAT
AGTAAGAGAGA -> GTAAGAGAGAG
AGTACGTTCCG -> GTACGTTCCGT
AGTAGGCATTT -> GTAGGCATTTA
AGTATCATGCA -> GTATCATGCAG
AGTCAAGTTGA -> GTCAAGTTGAT
AGTCATAGGAA -> GTCATAGGAAA
AGTCCTAGCTG -> GTCCTAGCTGA
AGTCCTCTCAA -> GTCCTCTCAAC
AGTCGTCCAAT -> GTCGTCCAATT
AGTCTACTGTG -> GTCTACTGTGA
AGTCTAGGCTT -> GTCTAGGCTTA
AGTCTCGGGAT -> GTCTCGGGATG
AGTGACACTTT -> GTGACACTTTC
AGTGACTATGG -> GTGACTATGGT
AGTGCAAACTG -> GTGCAAACTGC
AGTGCAAAGAG -> GTGCAAAGAGT
AGTGCAATGCA -> GTGCAATGCAG
AGTGCAGGGTT -> GTGCAGGGTTA
AGTGCCCGGTT -> GTGCCCGGTTG
AGTGCTCTCAT -> GTGCTCTCATT
AGTGGATAGTA -> GTGGATAGTAT
AGTTACACATG -> GTTACACATGA
AGTTATTTGTG -> GTTATTTGTGG
AGTTCAAACCG -> GTTCAAACCGC
AGTTCACAATT -> GTTCACAATTC
AGTTGATGGAG -> GTTGATGGAGC
AGTTGGATCAC -> GTTGGATCACG
AGTTTATGCTT -> GTTTATGCTTA
AGTTTTTTGGT -> GTTTTTTGGTT
ATAAATACAGC -> TAAATACAGCC
ATAACGAGACA -> TAACGAGACAA
ATAACGGCCGT -> TAACGGCCGTC
ATAACTCGTAA -> TAACTCGTAAC
ATAAGAAGTGC -> TAAGAAGTGCC
ATAAGACATAC -> TAAGACATACT
ATAATGAGCGG -> TAATGAGCGGG
ATAATGCCAGC -> TAATGCCAGCA
ATAATGTCAAG -> TAATGTCAAGT
ATACAGCCGTA -> TACAGCCGTAC
ATACAGGCATC -> TACAGGCATCG
ATACATCGCAC -> TACATCGCACC
ATACATCTTTT -> TACATCTTTTT
ATACCGGGGCC -> TACCGGGGCCA
ATACCTAACGA -> TACCTAACGAC
ATACGCGAGCG -> TACGCGAGCGA
ATACTCCTACA -> TACTCCTACAA
ATACTGTGTAA -> TACTGTGTAAG
ATAGATCGCAA -> TAGATCGCAAC
ATAGGAAAGTT -> TAGGAAAGTTC,TAGGAAAGTTG
ATAGGACATCA -> TAGGACATCAT
ATAGTATCATG -> TAGTATCATGC
ATAGTCTACTG -> TAGTCTACTGT
ATATAACTCGT -> TATAACTCGTA
ATATATCCTCT -> TATATCCTCTA
ATATCCTCTAA -> TATCCTCTAAC
ATATGTTGGGC -> TATGTTGGGCT
ATATTATGGCG -> TATTATGGCGC
ATATTTGCCGA -> TATTTGCCGAT
ATATTTTGTTC -> TATTTTGTTCA
ATCAAATGGTG -> TCAAATGGTGG
ATCACCTCGCT -> TCACCTCGCTT
ATCACGAGGGG -> TCACGAGGGGG
ATCATCTAAGG -> TCATCTAAGGA
ATCATGCAGAA -> TCATGCAGAAT
ATCATGTCGGG -> TCATGTCGGGA
ATCATTTGGAT -> TCATTTGGATC
ATCCCAGGTGT -> TCCCAGGTGTG
ATCCCTTACAT -> TCCCTTACATT
ATCCGCCATCC -> TCCGCCATCCG
ATCCGCCCGGA -> TCCGCCCGGAC
ATCCGTCAGTC -> TCCGTCAGTCA
ATCCTCCTTAT -> TCCTCCTTATG
ATCCTCTAACA -> TCCTCTAACAA
ATCCTGCGTTA -> TCCTGCGTTAT
ATCCTTGTTCA -> TCCTTGTTCAT
ATCGACTTCAG -> TCGACTTCAGG
ATCGCAACTCC -> TCGCAACTCCG
ATCGCAATTCC -> TCGCAATTCCC
ATCGCACCAAC -> TCGCACCAACT
ATCGGGAACTC -> TCGGGAACTCA
ATCGGGCTCCT -> TCGGGCTCCTC
ATCGGTATCAT -> TCGGTATCATC
ATCGTGACGCC -> TCGTGACGCCT
ATCTAAGGACT -> TCTAAGGACTA
ATCTACCAGGG -> TCTACCAGGGT
ATCTAGCCCAG -> TCTAGCCCAGC
ATCTCTATGGT -> TCTCTATGGTC
ATCTGCTGGTC -> TCTGCTGGTCT
ATCTGGGCTCC -> TCTGGGCTCCC
ATCTTCGTCTC -> TCTTCGTCTCC
ATCTTTTTCGC -> TCTTTTTCGCG
ATGAACGGCAA -> TGAACGGCAAA
ATGAACTCGCG -> TGAACTCGCGA
ATGAAGCACAA -> TGAAGCACAAC
ATGACACTCCT -> TGACACTCCTG
ATGACATCGGG -> TGACATCGGGC
ATGACCGGTCT -> TGACCGGTCTT
ATGACGACGTC -> TGACGACGTCG
ATGAGACTGTC -> TGAGACTGTCC
ATGAGCGGGTT -> TGAGCGGGTTA
ATGAGCTGACT -> TGAGCTGACTA
ATGAGTTACAC -> TGAGTTACACA
ATGATACTCCT -> TGATACTCCTA
ATGATTGTACG -> TGATTGTACGC
ATGCAGAATTA -> TGCAGAATTAG
ATGCAGTTTAT -> TGCAGTTTATG
ATGCCAGCATT -> TGCCAGCATTG
ATGCCCTGGCA -> TGCCCTGGCAA
ATGCTTAGTAG -> TGCTTAGTAGG
ATGGAACCCAA -> TGGAACCCAAT
ATGGAATGGCT -> TGGAATGGCTG
ATGGAGCAGAC -> TGGAGCAGACT
ATGGCACGTCA -> TGGCACGTCAC
ATGGCGCGAAA -> TGGCGCGAAAT
ATGGCTGCACG -> TGGCTGCACGG
ATGGTCACTGT -> TGGTCACTGTA
ATGGTCGTAAG -> TGGTCGTAAGA
ATGGTCTAACT -> TGGTCTAACTA
ATGGTGGGATG -> TGGTGGGATGG
ATGGTTAAGGA -> TGGTTAAGGAG
ATGTAACCCGA -> TGTAACCCGAG
ATGTAAGGATT -> TGTAAGGATTG
ATGTCAAGTGC -> TGTCAAGTGCA
ATGTCACGTAA -> TGTCACGTAAA
ATGTCGGGAAC -> TGTCGGGAACC
ATGTGGAGGCT -> TGTGGAGGCTA
ATGTTGGGCTG -> TGTTGGGCTGA
ATTAACGCATA -> TTAACGCATAG
ATTAAGACTGC -> TTAAGACTGCC
ATTAGATCGCA -> TTAGATCGCAA
ATTAGCTAAGA -> TTAGCTAAGAT
ATTATAGGACA -> TTATAGGACAT
ATTATGGCGCG -> TTATGGCGCGA
ATTCATAAGAA -> TTCATAAGAAG
ATTCATAATGT -> TTCATAATGTC
ATTCCCAGAGT -> TTCCCAGAGTG
ATTCCCCGTAG -> TTCCCCGTAGC
ATTCCCCTCTC -> TTCCCCTCTCC
ATTCCCGGGGT -> TTCCCGGGGTG
ATTCGTGTTTC -> TTCGTGTTTCT
ATTCTAGAAAC -> TTCTAGAAACA
ATTGACACTTA -> TTGACACTTAT
ATTGAGACGCG -> TTGAGACGCGA
ATTGCCACCCA -> TTGCCACCCAC
ATTGCGTATAC -> TTGCGTATACA
ATTGGGCTTGG -> TTGGGCTTGGT
ATTGTACGCAG -> TTGTACGCAGA
ATTGTCAACAC -> TTGTCAACACC
ATTGTGCCACC -> TTGTGCCACCT
ATTGTTAGCCA -> TTGTTAGCCAA
ATTTACGCTGA -> TTTACGCTGAG
ATTTAGAGAAT -> TTTAGAGAATT
ATTTCTTCAAA -> TTTCTTCAAAT
ATTTGCCGATT -> TTTGCCGATTT
ATTTGGATCTC -> TTTGGATCTCT
ATTTGGGGTCA -> TTTGGGGTCAG
ATTTGTGGGAG -> TTTGTGGGAGT
ATTTTCGCTAA -> TTTTCGCTAAT
ATTTTGTTCAC -> TTTTGTTCACA
ATTTTTCATCC -> TTTTTCATCCT
CAAAAATTGAG -> AAAAATTGAGA
CAAAACCGGTT -> AAAACCGGTTA
CAAACAGGATC -> AAACAGGATCC
CAAACATTCTA -> AAACATTCTAG
CAAACCGCCTT -> AAACCGCCTTT
CAAACTGCCGG -> AAACTGCCGGA
CAAAGAGTCAA -> AAAGAGTCAAG
CAAATGAACGG -> AAATGAACGGC
CAAATGGTGGG -> AAATGGTGGGA
CAACACCCCCT -> AACACCCCCTG
CAACATAACGA -> AACATAACGAG
CAACATTGTTA -> AACATTGTTAG
CAACCAATACC -> AACCAATACCG
CAACCGTCGGC -> AACCGTCGGCC
CAACCTTATGA -> AACCTTATGAA
CAACTAATAAC -> AACTAATAACG
CAACTCCGGTC -> AACTCCGGTCC
CAACTCCTTAC -> AACTCCTTACT
CAACTGCCCAA -> AACTGCCCAAA
CAACTTCCGTG -> AACTTCCGTGG
CAAGCTTGGCC -> AAGCTTGGCCA
CAAGTACGTTC -> AAGTACGTTCC
CAAGTGCAAAG -> AAGTGCAAAGA
CAAGTTATTTG -> AAGTTATTTGT
CAAGTTGATGG -> AAGTTGATGGA
CAATACATCTT -> AATACATCTTT
CAATACCGGGG -> AATACCGGGGC
CAATATTTTGT -> AATATTTTGTT
CAATGACCGGT -> AATGACCGGTC
CAATGCAGTTT -> AATGCAGTTTA
CAATGGCACGT -> AATGGCACGTC
CAATTATAGGA -> AATTATAGGAC
CAATTCCCCGT -> AATTCCCCGTA
CAATTCGTGTT -> AATTCGTGTTT
CAATTTAGAGA -> AATTTAGAGAA
CACAACATAAC -> ACAACATAACG
CACAAGTACGT -> ACAAGTACGTT
CACAATATTTT -> ACAATATTTTG
CACAATTCGTG -> ACAATTCGTGT
CACACAATATT -> ACACAATATTT
CACACACAATA -> ACACACAATAT
CACACCTCCTT -> ACACCTCCTTA
CACATGACACT -> ACATGACACTC
CACATGAGCTG -> ACATGAGCTGA
CACCAACTAAT -> ACCAACTAATA
CACCCACTGCA -> ACCCACTGCAC
CACCCCCTGAA -> ACCCCCTGAAA
CACCGGGAGCG -> ACCGGGAGCGG
CACCTAAATGA -> ACCTAAATGAT
CACCTCAACCA -> ACCTCAACCAA
CACCTCCTTAA -> ACCTCCTTAAC
CACCTCGCTTC -> ACCTCGCTTCA
CACCTGCGCCC -> ACCTGCGCCCA
CACGAGGGGGT -> ACGAGGGGGTG
CACGGCTGGGC -> ACGGCTGGGCA
CACGGGAGCAG -> ACGGGAGCAGC
CACGTAAACCG -> ACGTAAACCGC
CACGTCACTAG -> ACGTCACTAGT
CACTAGTGGAT -> ACTAGTGGATA
CACTCCTGTCT -> ACTCCTGTCTG
CACTCCTTTCG -> ACTCCTTTCGC
CACTGCACACC -> ACTGCACACCT
CACTGTAGACC -> ACTGTAGACCA
CACTTAATGGA -> ACTTAATGGAA
CACTTATATGT -> ACTTATATGTT
CACTTGAGGTC -> ACTTGAGGTCA
CACTTGGACGG -> ACTTGGACGGA
CACTTTCGTCA -> ACTTTCGTCAG
CAGAATTAGCT -> AGAATTAGCTA
CAGACTCAGCC -> AGACTCAGCCG
CAGAGAGACGT -> AGAGAGACGTT
CAGAGTCGTCC -> AGAGTCGTCCA
CAGAGTGACTA -> AGAGTGACTAT
CAGATCCCAGG -> AGATCCCAGGT
CAGATCCGCCA -> AGATCCGCCAT
CAGATCGGTAT -> AGATCGGTATC
CAGCATATTTG -> AGCATATTTGC
CAGCATTGCCA -> AGCATTGCCAC
CAGCCGATTGA -> AGCCGATTGAC
CAGCCGCCACT -> AGCCGCCACTT
CAGCCGTACAC -> AGCCGTACACT
CAGCGCGTTCT -> AGCGCGTTCTA
CAGGATACGCG -> AGGATACGCGA
CAGGATCCCTT -> AGGATCCCTTA
CAGGCATCGGG -> AGGCATCGGGA
CAGGCATGATT -> AGGCATGATTG
CAGGGCCTTGA -> AGGGCCTTGAC
CAGGGCTACCG -> AGGGCTACCGT
CAGGGTACGAC -> AGGGTACGACA
CAGGGTCAATG -> AGGGTCAATGG
CAGGGTTATCA -> AGGGTTATCAA
CAGGTGATCTA -> AGGTGATCTAC
CAGGTGGATGT -> AGGTGGATGTA
CAGGTGTGTAC -> AGGTGTGTACC
CAGGTGTTACG -> AGGTGTTACGA
CAGTAAGAGAG -> AGTAAGAGAGA
CAGTCATAGGA -> AGTCATAGGAA
CAGTTCACAAT -> AGTTCACAATT
CAGTTTATGCT -> AGTTTATGCTT
CATAAATACAG -> ATAAATACAGC
CATAACGAGAC -> ATAACGAGACA
CATAAGAAGTG -> ATAAGAAGTGC
CATAATGTCAA -> ATAATGTCAAG
CATACAGGCAT -> ATACAGGCATC
CATACCTAACG -> ATACCTAACGA
CATACTGTGTA -> ATACTGTGTAA
CATAGATCGCA -> ATAGATCGCAA
CATAGGAAAGT -> ATAGGAAAGTT,ATAGGAAAGTT
CATATTTGCCG -> ATATTTGCCGA
CATCATGTCGG -> ATCATGTCGGG
CATCATTTGGA -> ATCATTTGGAT
CATCCGTCAGT -> ATCCGTCAGTC
CATCCTCCTTA -> ATCCTCCTTAT
CATCCTGCGTT -> ATCCTGCGTTA
CATCGACTTCA -> ATCGACTTCAG
CATCGCACCAA -> ATCGCACCAAC
CATCGGGAACT -> ATCGGGAACTC
CATCGGGCTCC -> ATCGGGCTCCT
CATCTAAGGAC -> ATCTAAGGACT
CATCTAGCCCA -> ATCTAGCCCAG
CATCTTTTTCG -> ATCTTTTTCGC
CATGACACTCC -> ATGACACTCCT
CATGAGCTGAC -> ATGAGCTGACT
CATGATTGTAC -> ATGATTGTACG
CATGCAGAATT -> ATGCAGAATTA
CATGTCGGGAA -> ATGTCGGGAAC
CATGTGGAGGC -> ATGTGGAGGCT
CATTAACGCAT -> ATTAACGCATA
CATTCCCCTCT -> ATTCCCCTCTC
CATTCCCGGGG -> ATTCCCGGGGT
CATTCTAGAAA -> ATTCTAGAAAC
CATTGCCACCC -> ATTGCCACCCA
CATTGTCAACA -> ATTGTCAACAC
CATTGTTAGCC -> ATTGTTAGCCA
CATTTACGCTG -> ATTTACGCTGA
CATTTGGATCT -> ATTTGGATCTC
CCAAAACCGGT -> CAAAACCGGTT
CCAAACAGGAT -> CAAACAGGATC
CCAACTAATAA -> CAACTAATAAC
CCAATACATCT -> CAATACATCTT
CCAATACCGGG -> CAATACCGGGG
CCAATTATAGG -> CAATTATAGGA
CCAATTTAGAG -> CAATTTAGAGA
CCACACACAAT -> CACACACAATA
CCACATGACAC -> CACATGACACT
CCACCCACTGC -> CACCCACTGCA
CCACCTGCGCC -> CACCTGCGCCC
CCACTGCACAC -> CACTGCACACC
CCACTTGGACG -> CACTTGGACGG
CCAGAGAGACG -> CAGAGAGACGT
CCAGAGTGACT -> CAGAGTGACTA
CCAGCATTGCC -> CAGCATTGCCA
CCAGCCGATTG -> CAGCCGATTGA
CCAGGGCCTTG -> CAGGGCCTTGA
CCAGGGCTACC -> CAGGGCTACCG
CCAGGGTACGA -> CAGGGTACGAC
CCAGGGTCAAT -> CAGGGTCAATG
CCAGGTGTGTA -> CAGGTGTGTAC
CCAGGTGTTAC -> CAGGTGTTACG
CCAGTTCACAA -> CAGTTCACAAT
CCATACCTAAC -> CATACCTAACG
CCATCCGTCAG -> CATCCGTCAGT
CCATGTGGAGG -> CATGTGGAGGC
CCATTGTCAAC -> CATTGTCAACA
CCCAAAACCGG -> CCAAAACCGGT
CCCAATACATC -> CCAATACATCT
CCCACATGACA -> CCACATGACAC
CCCACTGCACA -> CCACTGCACAC
CCCAGAGTGAC -> CCAGAGTGACT
CCCAGCCGATT -> CCAGCCGATTG
CCCAGGTGTGT -> CCAGGTGTGTA
CCCAGGTGTTA -> CCAGGTGTTAC
CCCATACCTAA -> CCATACCTAAC
CCCCACATGAC -> CCCACATGACA
CCCCCTGAAAC -> CCCCTGAAACC
CCCCGCCTAGA -> CCCGCCTAGAG
CCCCGGCATAC -> CCCGGCATACA
CCCCGTAGCAT -> CCCGTAGCATT
CCCCTCTCCAG -> CCCTCTCCAGG
CCCCTGAAACC -> CCCTGAAACCC
CCCGAGAGAGA -> CCGAGAGAGAG
CCCGAGTCCTC -> CCGAGTCCTCT
CCCGCCTAGAG -> CCGCCTAGAGG
CCCGGACAACT -> CCGGACAACTC
CCCGGATTCCC -> CCGGATTCCCA
CCCGGCATACA -> CCGGCATACAG
CCCGGGGTGAC -> CCGGGGTGACA
CCCGGTTGATT -> CCGGTTGATTT
CCCGTAGCATT -> CCGTAGCATTC
CCCTACAAGTT -> CCTACAAGTTA
CCCTACATCCT -> CCTACATCCTG
CCCTCTCCAGG -> CCTCTCCAGGG
CCCTGAAACCC -> CCTGAAACCCG
CCCTGGCAAGC -> CCTGGCAAGCT
CCCTTACATTC -> CCTTACATTCC
CCGAGAGAGAG -> CGAGAGAGAGC
CCGAGTCCTCT -> CGAGTCCTCTC
CCGATTGACAC -> CGATTGACACT
CCGATTTTCGC -> CGATTTTCGCT
CCGCCACTTGG -> CGCCACTTGGA
CCGCCATCCGT -> CGCCATCCGTC
CCGCCCGGACA -> CGCCCGGACAA
CCGCCTAGAGG -> CGCCTAGAGGG
CCGCCTTTAGG -> CGCCTTTAGGG
CCGCGGTGCCT -> CGCGGTGCCTC
CCGCTCTAATG -> CGCTCTAATGA
CCGCTTACTAG -> CGCTTACTAGC
CCGGACAACTC -> CGGACAACTCC
CCGGACTGCCT -> CGGACTGCCTT
CCGGATTCCCA -> CGGATTCCCAG
CCGGCATACAG -> CGGCATACAGG
CCGGGAGCGGC -> CGGGAGCGGCT
CCGGGGCCATG -> CGGGGCCATGT
CCGGGGTGACA -> CGGGGTGACAT
CCGGTCCCCGC -> CGGTCCCCGCC
CCGGTCTTCTC -> CGGTCTTCTCA
CCGGTGAAGCG -> CGGTGAAGCGC
CCGGTTAAGGC -> CGGTTAAGGCT
CCGGTTGATTT -> CGGTTGATTTC
CCGTACACTTG -> CGTACACTTGA
CCGTAGAAAAT -> CGTAGAAAATG
CCGTAGCATTC -> CGTAGCATTCC
CCGTCAGTCAT -> CGTCAGTCATA
CCGTCCGCGGT -> CGTCCGCGGTG
CCGTCCTGACC -> CGTCCTGACCC
CCGTCGGCCTG -> CGTCGGCCTGC
CCGTGACAGGA -> CGTGACAGGAT
CCGTGGGTCTA -> CGTGGGTCTAT
CCTAAATGATA -> CTAAATGATAC
CCTAACGACCT -> CTAACGACCTC
CCTACAAGTTA -> CTACAAGTTAT
CCTACAATGAC -> CTACAATGACC
CCTACATCCTG -> CTACATCCTGC
CCTAGAGGGAC -> CTAGAGGGACC
CCTAGCTGAGG -> CTAGCTGAGGC
CCTAGTCCTAG -> CTAGTCCTAGC
CCTCAACCAAT -> CTCAACCAATA
CCTCCCCGGCA -> CTCCCCGGCAT
CCTCCTTAACA -> CTCCTTAACAC
CCTCCTTATGA -> CTCCTTATGAG
CCTCGAAATAT -> CTCGAAATATA
CCTCGCTTCAG -> CTCGCTTCAGT
CCTCGGATCCG -> CTCGGATCCGC
CCTCGTGCGAT -> CTCGTGCGATT
CCTCTAACAAC -> CTCTAACAACC
CCTCTAATTTT -> CTCTAATTTTT
CCTCTCAACAT -> CTCTCAACATT
CCTCTCCAGGG -> CTCTCCAGGGC
CCTCTGTGGGA -> CTCTGTGGGAC
CCTGAAACCCG -> CTGAAACCCGA
CCTGACCCTAC -> CTGACCCTACA
CCTGATAGTCT -> CTGATAGTCTA
CCTGCGCCCAT -> CTGCGCCCATA
CCTGCGTAGTT -> CTGCGTAGTTT
CCTGCGTTATC -> CTGCGTTATCT
CCTGGCAAGCT -> CTGGCAAGCTT
CCTGTATTGGG -> CTGTATTGGGC
CCTGTCTGTTG -> CTGTCTGTTGG
CCTTAACACCT -> CTTAACACCTC
CCTTACATTCC -> CTTACATTCCC
CCTTACTGAAG -> CTTACTGAAGA
CCTTATGAACT -> CTTATGAACTC
CCTTATGAGTT -> CTTATGAGTTA
CCTTGACACTC -> CTTGACACTCC
CCTTGTTCATC -> CTTGTTCATCG
CCTTTAAGACT -> CTTTAAGACTC
CCTTTAGGGTT -> CTTTAGGGTTC
CCTTTCGCGTG -> CTTTCGCGTGG
CGAAATATAAC -> GAAATATAACT
CGAAATATATC -> GAAATATATCC
CGAAGTGCAGG -> GAAGTGCAGGG
CGACAACCGTC -> GACAACCGTCG
CGACACCGGGA -> GACACCGGGAG
CGACCTCGTGC -> GACCTCGTGCG
CGACGTCGAAG -> GACGTCGAAGT
CGACTTCAGGT -> GACTTCAGGTG
CGAGACAACTT -> GAGACAACTTC
CGAGACACGGC -> GAGACACGGCT
CGAGAGAGAGC -> GAGAGAGAGCG
CGAGCGAGACA -> GAGCGAGACAC
CGAGGGATAAT -> GAGGGATAATG
CGAGGGGGTGC -> GAGGGGGTGCT
CGAGTCCTCTC -> GAGTCCTCTCA
CGATCACCTCG -> GATCACCTCGC
CGATCTGCTGG -> GATCTGCTGGT
CGATTGACACT -> GATTGACACTT
CGATTGCGTAT -> GATTGCGTATA
CGATTTTCGCT -> GATTTTCGCTA
CGCAACTCCGG -> GCAACTCCGGT
CGCAATTCCCC -> GCAATTCCCCG
CGCACCAACTA -> GCACCAACTAA
CGCAGATCCCA -> GCAGATCCCAG
CGCATAGATCG -> GCATAGATCGC
CGCCACACACA -> GCCACACACAA
CGCCACTTGGA -> GCCACTTGGAC
CGCCATCCGTC -> GCCATCCGTCA
CGCCCATACCT -> GCCCATACCTA
CGCCCGGACAA -> GCCCGGACAAC
CGCCTAGAGGG -> GCCTAGAGGGA
CGCCTAGTCCT -> GCCTAGTCCTA
CGCCTTTAGGG -> GCCTTTAGGGT
CGCGAAATATA -> GCGAAATATAT
CGCGAGCGAGA -> GCGAGCGAGAC
CGCGAGGGATA -> GCGAGGGATAA
CGCGATCTGCT -> GCGATCTGCTG
CGCGGTGCCTC -> GCGGTGCCTCT
CGCGTGGAAAT -> GCGTGGAAATA
CGCGTTCTATG -> GCGTTCTATGG
CGCTAATCCTT -> GCTAATCCTTG
CGCTCTAATGA -> GCTCTAATGAG
CGCTGAGTAAC -> GCTGAGTAACC
CGCTTACTAGC -> GCTTACTAGCC
CGCTTCAGTAA -> GCTTCAGTAAG
CGGAAGTGCAA -> GGAAGTGCAAT
CGGACAACTCC -> GGACAACTCCT
CGGACTGCCTT -> GGACTGCCTTT
CGGATCCGCCC -> GGATCCGCCCG
CGGATTCCCAG -> GGATTCCCAGA
CGGCAAACATT -> GGCAAACATTC
CGGCATACAGG -> GGCATACAGGC
CGGCCGTCCGC -> GGCCGTCCGCG
CGGCCTCGAAA -> GGCCTCGAAAT
CGGCCTGCGTA -> GGCCTGCGTAG
CGGCTAGTGCA -> GGCTAGTGCAA
CGGCTGGGCAT -> GGCTGGGCATA
CGGGAACCAGG -> GGGAACCAGGG
CGGGAACTCAT -> GGGAACTCATA
CGGGAGCAGCA -> GGGAGCAGCAT
CGGGAGCGGCT -> GGGAGCGGCTA
CGGGATGACAT -> GGGATGACATC
CGGGCTCCTCT -> GGGCTCCTCTG
CGGGGCCATGT -> GGGGCCATGTG
CGGGGTGACAT -> GGGGTGACATC
CGGGTTAAATG -> GGGTTAAATGG
CGGTATCATCT -> GGTATCATCTA
CGGTCCCCGCC -> GGTCCCCGCCT
CGGTCTTCTCA -> GGTCTTCTCAG
CGGTGAAGCGC -> GGTGAAGCGCC
CGGTGCCTCTA -> GGTGCCTCTAA
CGGTTAAGGCT -> GGTTAAGGCTT
CGGTTGATTTC -> GGTTGATTTCT
CGTAAACCGCT -> GTAAACCGCTT
CGTAACGTATA -> GTAACGTATAA
CGTAAGACTAT -> GTAAGACTATG
CGTACACTTGA -> GTACACTTGAG
CGTAGAAAATG -> GTAGAAAATGA
CGTAGCATTCC -> GTAGCATTCCC
CGTAGTTTTTT -> GTAGTTTTTTG
CGTATAAGACA -> GTATAAGACAT
CGTATACATCG -> GTATACATCGC
CGTATCTGGGC -> GTATCTGGGCT
CGTCACTAGTG -> GTCACTAGTGG
CGTCAGGCATG -> GTCAGGCATGA
CGTCAGTCATA -> GTCAGTCATAG
CGTCCAATTAT -> GTCCAATTATA
CGTCCGCGGTG -> GTCCGCGGTGC
CGTCCGCTCTA -> GTCCGCTCTAA
CGTCCTGACCC -> GTCCTGACCCT
CGTCGAAGTGC -> GTCGAAGTGCA
CGTCGGCCTGC -> GTCGGCCTGCG
CGTCTCCTCCC -> GTCTCCTCCCC
CGTGACAGGAT -> GTGACAGGATA
CGTGACGCCTA -> GTGACGCCTAG
CGTGAGCAGGT -> GTGAGCAGGTG
CGTGCGATTGC -> GTGCGATTGCG
CGTGGAAATAT -> GTGGAAATATT
CGTGGGTCTAT -> GTGGGTCTATT
CGTGTTTCTCC -> GTGTTTCTCCA
CGTTATCTTCG -> GTTATCTTCGT
CGTTCCGTGAC -> GTTCCGTGACA
CGTTCGTATCT -> GTTCGTATCTG
CGTTCTATGGT -> GTTCTATGGTC
CTAAATGATAC -> TAAATGATACT
CTAACAACCTT -> TAACAACCTTA
CTAACGACCTC -> TAACGACCTCG
CTAACTATTTG -> TAACTATTTGG
CTAAGATGTAA -> TAAGATGTAAC
CTAAGGACTAT -> TAAGGACTATC
CTAATAACGGC -> TAATAACGGCC
CTAATAATGAG -> TAATAATGAGC
CTAATCCTTGT -> TAATCCTTGTT
CTAATGAGACT -> TAATGAGACTG
CTAATTTTTCA -> TAATTTTTCAT
CTACAAGTTAT -> TACAAGTTATT
CTACAATGACC -> TACAATGACCG
CTACATCCTGC -> TACATCCTGCG
CTACCAGGGTA -> TACCAGGGTAC
CTACCGTCCTG -> TACCGTCCTGA
CTACTGTGACA -> TACTGTGACAG
CTAGAAACACT -> TAGAAACACTT
CTAGAGGGACC -> TAGAGGGACCC
CTAGCAAAAAT -> TAGCAAAAATT
CTAGCCCAGCC -> TAGCCCAGCCG
CTAGCCGGTGA -> TAGCCGGTGAA
CTAGCTAGCTT -> TAGCTAGCTTA
CTAGCTGAGGC -> TAGCTGAGGCC
CTAGCTTACCT -> TAGCTTACCTC
CTAGGCTTACG -> TAGGCTTACGG
CTAGTCCTAGC -> TAGTCCTAGCT
CTAGTGACACT -> TAGTGACACTT
CTAGTGCAAAC -> TAGTGCAAACT
CTAGTGGATAG -> TAGTGGATAGT
CTATCGTGACG -> TATCGTGACGC
CTATGGTCACT -> TATGGTCACTG
CTATGGTCGTA -> TATGGTCGTAA
CTATGGTCTAA -> TATGGTCTAAC
CTATGTCACGT -> TATGTCACGTA
CTATTAGATCG -> TATTAGATCGC
CTATTTGGGGT -> TATTTGGGGTC
CTCAACATTGT -> TCAACATTGTT
CTCAACCAATA -> TCAACCAATAC
CTCAGAGTCGT -> TCAGAGTCGTC
CTCAGCCGCCA -> TCAGCCGCCAC
CTCATAAATAC -> TCATAAATACA
CTCATTAACGC -> TCATTAACGCA
CTCCAGGGCCT -> TCCAGGGCCTT
CTCCAGGGCTA -> TCCAGGGCTAC
CTCCCCACATG -> TCCCCACATGA
CTCCCCGGCAT -> TCCCCGGCATA
CTCCCGGATTC -> TCCCGGATTCC
CTCCGGTCCCC -> TCCGGTCCCCG
CTCCTACAATG -> TCCTACAATGA
CTCCTCCCCGG -> TCCTCCCCGGC
CTCCTCTGTGG -> TCCTCTGTGGG
CTCCTGTCTGT -> TCCTGTCTGTT
CTCCTTAACAC -> TCCTTAACACC
CTCCTTACTGA -> TCCTTACTGAA
CTCCTTATGAG -> TCCTTATGAGT
CTCCTTTCGCG -> TCCTTTCGCGT
CTCGAAATATA -> TCGAAATATAA
CTCGCGAGGGA -> TCGCGAGGGAT
CTCGCTTCAGT -> TCGCTTCAGTA
CTCGGATCCGC -> TCGGATCCGCC
CTCGGGATGAC -> TCGGGATGACA
CTCGTAACGTA -> TCGTAACGTAT
CTCGTCCGCTC -> TCGTCCGCTCT
CTCGTGCGATT -> TCGTGCGATTG
CTCTAACAACC -> TCTAACAACCT
CTCTAATGAGA -> TCTAATGAGAC
CTCTAATTTTT -> TCTAATTTTTC
CTCTATGGTCT -> TCTATGGTCTA
CTCTCAACATT -> TCTCAACATTG
CTCTCATTAAC -> TCTCATTAACG
CTCTCCAGGGC -> TCTCCAGGGCC
CTCTGTGGGAC -> TCTGTGGGACG
CTGAAAATTCA -> TGAAAATTCAT
CTGAAACCCGA -> TGAAACCCGAG
CTGAAGAGATG -> TGAAGAGATGC
CTGACCCTACA -> TGACCCTACAT
CTGACTAGCAA -> TGACTAGCAAA
CTGAGGCCAGT -> TGAGGCCAGTT
CTGAGTAACCT -> TGAGTAACCTG
CTGATAGTCTA -> TGATAGTCTAC
CTGCACACCTC -> TGCACACCTCC
CTGCACGGGAG -> TGCACGGGAGC
CTGCCCAAAAC -> TGCCCAAAACC
CTGCCCAGGTG -> TGCCCAGGTGT
CTGCCGGACTG -> TGCCGGACTGC
CTGCCTTTAAG -> TGCCTTTAAGA
CTGCGCCCATA -> TGCGCCCATAC
CTGCGTAGTTT -> TGCGTAGTTTT
CTGCGTTATCT -> TGCGTTATCTT
CTGCTGGTCTA -> TGCTGGTCTAG
CTGGCAAGCTT -> TGGCAAGCTTG
CTGGGCATAGG -> TGGGCATAGGA
CTGGGCTCCCG -> TGGGCTCCCGG
CTGGTCTAGTG -> TGGTCTAGTGA
CTGTAGACCAG -> TGTAGACCAGA
CTGTATTGGGC -> TGTATTGGGCT
CTGTCCGTAGA -> TGTCCGTAGAA
CTGTCTGTTGG -> TGTCTGTTGGA
CTGTGACAGAT -> TGTGACAGATC
CTGTGGGACGT -> TGTGGGACGTG
CTGTGTAAGGT -> TGTGTAAGGTT
CTGTTGGACCA -> TGTTGGACCAT
CTTAACACCTC -> TTAACACCTCA
CTTAATGGAAC -> TTAATGGAACC
CTTACATTCCC -> TTACATTCCCG
CTTACCTCGGA -> TTACCTCGGAT
CTTACGGCCTC -> TTACGGCCTCG
CTTACTAGCCG -> TTACTAGCCGG
CTTACTGAAGA -> TTACTGAAGAG
CTTAGTAGGCA -> TTAGTAGGCAT
CTTATATGTTG -> TTATATGTTGG
CTTATGAACTC -> TTATGAACTCG
CTTATGAGTTA -> TTATGAGTTAC
CTTCAAATGAA -> TTCAAATGAAC
CTTCAGGTGGA -> TTCAGGTGGAT
CTTCAGTAAGA -> TTCAGTAAGAG
CTTCCGTGGGT -> TTCCGTGGGTC
CTTCGTCTCCT -> TTCGTCTCCTC
CTTCTCAGAGT -> TTCTCAGAGTC
CTTGACACTCC -> TTGACACTCCT
CTTGAGGTCAA -> TTGAGGTCAAC
CTTGGACGGAA -> TTGGACGGAAG
CTTGGCCAATT -> TTGGCCAATTT
CTTGGTCAGCG -> TTGGTCAGCGC
CTTGTATTCAT -> TTGTATTCATA
CTTGTTCATCG -> TTGTTCATCGA
CTTTAAGACTC -> TTTAAGACTCG
CTTTAGGGTTC -> TTTAGGGTTCA
CTTTCGCGTGG -> TTTCGCGTGGA
CTTTCGTCAGG -> TTTCGTCAGGC
GAAAATGAAGC -> AAAATGAAGCA
GAAAATTCATA -> AAAATTCATAA
GAAACACTTAA -> AAACACTTAAT
GAAACCCGAGA -> AAACCCGAGAG
GAAAGTTCAAA -> AAAGTTCAAAC
GAAAGTTGGAT -> AAAGTTGGATC
GAAATATAACT -> AAATATAACTC
GAAATATATCC -> AAATATATCCT
GAAATATTATG -> AAATATTATGG
GAACCAGGGTC -> AACCAGGGTCA
GAACCCAATAC -> AACCCAATACA
GAACGGCAAAC -> AACGGCAAACA
GAACTCATAAA -> AACTCATAAAT
GAACTCGCGAG -> AACTCGCGAGG
GAAGAGATGCC -> AAGAGATGCCC
GAAGCACAACA -> AAGCACAACAT
GAAGCGCCACA -> AAGCGCCACAC
GAAGTGCAATG -> AAGTGCAATGC
GAAGTGCAGGG -> AAGTGCAGGGT
GAAGTGCCCGG -> AAGTGCCCGGT
GAATGGCTGCA -> AATGGCTGCAC
GAATTAAGACT -> AATTAAGACTG
GAATTAGCTAA -> AATTAGCTAAG
GACAACCGTCG -> ACAACCGTCGG
GACAACTCCTT -> ACAACTCCTTA
GACAACTTCCG -> ACAACTTCCGT
GACACCGGGAG -> ACACCGGGAGC
GACACCTAAAT -> ACACCTAAATG
GACACGGCTGG -> ACACGGCTGGG
GACACTCCTGT -> ACACTCCTGTC
GACACTCCTTT -> ACACTCCTTTC
GACACTTATAT -> ACACTTATATG
GACACTTTCGT -> ACACTTTCGTC
GACAGATCCGC -> ACAGATCCGCC
GACAGGATACG -> ACAGGATACGC
GACATACTGTG -> ACATACTGTGT
GACATCATGTC -> ACATCATGTCG
GACATCGGGCT -> ACATCGGGCTC
GACATCTAGCC -> ACATCTAGCCC
GACCAGAGAGA -> ACCAGAGAGAC
GACCATTGTCA -> ACCATTGTCAA
GACCCTACAAG -> ACCCTACAAGT
GACCCTACATC -> ACCCTACATCC
GACCGGTCTTC -> ACCGGTCTTCT
GACCTCGTGCG -> ACCTCGTGCGA
GACGACGTCGA -> ACGACGTCGAA
GACGCCTAGTC -> ACGCCTAGTCC
GACGCGATCTG -> ACGCGATCTGC
GACGGAAGTGC -> ACGGAAGTGCA
GACGTCGAAGT -> ACGTCGAAGTG
GACGTGAGCAG -> ACGTGAGCAGG
GACGTTCGTAT -> ACGTTCGTATC
GACTAGCAAAA -> ACTAGCAAAAA
GACTATCGTGA -> ACTATCGTGAC
GACTATGGTCG -> ACTATGGTCGT
GACTATGTCAC -> ACTATGTCACG
GACTCAGCCGC -> ACTCAGCCGCC
GACTCGTCCGC -> ACTCGTCCGCT
GACTGCCCAGG -> ACTGCCCAGGT
GACTGCCTTTA -> ACTGCCTTTAA
GACTGTCCGTA -> ACTGTCCGTAG
GACTTCAGGTG -> ACTTCAGGTGG
GAGAATTAAGA -> AGAATTAAGAC
GAGACAACTTC -> AGACAACTTCC
GAGACACCTAA -> AGACACCTAAA
GAGACACGGCT -> AGACACGGCTG
GAGACGCGATC -> AGACGCGATCT
GAGACGTTCGT -> AGACGTTCGTA
GAGACTGTCCG -> AGACTGTCCGT
GAGAGACACCT -> AGAGACACCTA
GAGAGACGTTC -> AGAGACGTTCG
GAGAGAGACAC -> AGAGAGACACC
GAGAGAGAGCG -> AGAGAGAGCGA
GAGAGAGCGAT -> AGAGAGCGATC
GAGAGCGATCA -> AGAGCGATCAC
GAGATGCCCTG -> AGATGCCCTGG
GAGCAGACTCA -> AGCAGACTCAG
GAGCAGCATAT -> AGCAGCATATT
GAGCAGGTGAT -> AGCAGGTGATC
GAGCGAGACAC -> AGCGAGACACG
GAGCGATCACC -> AGCGATCACCT
GAGCGGCTAGT -> AGCGGCTAGTG
GAGCGGGTTAA -> AGCGGGTTAAA
GAGCTGACTAG -> AGCTGACTAGC
GAGGCCAGTTC -> AGGCCAGTTCA
GAGGCTAATAA -> AGGCTAATAAT
GAGGGACCCTA -> AGGGACCCTAC
GAGGGATAATG -> AGGGATAATGC
GAGGGGGTGCT -> AGGGGGTGCTA
GAGGTCAACTG -> AGGTCAACTGC
GAGTAACCTGT -> AGTAACCTGTA
GAGTCAAGTTG -> AGTCAAGTTGA
GAGTCCTCTCA -> AGTCCTCTCAA
GAGTCGTCCAA -> AGTCGTCCAAT
GAGTCTAGGCT -> AGTCTAGGCTT
GAGTCTCGGGA -> AGTCTCGGGAT
GAGTGACTATG -> AGTGACTATGG
GAGTGCTCTCA -> AGTGCTCTCAT
GAGTTACACAT -> AGTTACACATG
GATAATGCCAG -> ATAATGCCAGC
GATACGCGAGC -> ATACGCGAGCG
GATACTCCTAC -> ATACTCCTACA
GATAGTATCAT -> ATAGTATCATG
GATAGTCTACT -> ATAGTCTACTG
GATCACCTCGC -> ATCACCTCGCT
GATCACGAGGG -> ATCACGAGGGG
GATCCCAGGTG -> ATCCCAGGTGT
GATCCCTTACA -> ATCCCTTACAT
GATCCGCCATC -> ATCCGCCATCC
GATCCGCCCGG -> ATCCGCCCGGA
GATCGCAACTC -> ATCGCAACTCC
GATCGCAATTC -> ATCGCAATTCC
GATCGGTATCA -> ATCGGTATCAT
GATCTACCAGG -> ATCTACCAGGG
GATCTCTATGG -> ATCTCTATGGT
GATCTGCTGGT -> ATCTGCTGGTC
GATGACATCGG -> ATGACATCGGG
GATGCCCTGGC -> ATGCCCTGGCA
GATGGAATGGC -> ATGGAATGGCT
GATGGAGCAGA -> ATGGAGCAGAC
GATGTAACCCG -> ATGTAACCCGA
GATGTAAGGAT -> ATGTAAGGATT
GATTCCCAGAG -> ATTCCCAGAGT
GATTGACACTT -> ATTGACACTTA
GATTGCGTATA -> ATTGCGTATAC
GATTGTACGCA -> ATTGTACGCAG
GATTGTGCCAC -> ATTGTGCCACC
GATTTCTTCAA -> ATTTCTTCAAA
GATTTTCGCTA -> ATTTTCGCTAA
GCAAAAATTGA -> CAAAAATTGAG
GCAAACATTCT -> CAAACATTCTA
GCAAACTGCCG -> CAAACTGCCGG
GCAAAGAGTCA -> CAAAGAGTCAA
GCAACTCCGGT -> CAACTCCGGTC
GCAAGCTTGGC -> CAAGCTTGGCC
GCAATGCAGTT -> CAATGCAGTTT
GCAATTCCCCG -> CAATTCCCCGT
GCACAACATAA -> CACAACATAAC
GCACACCTCCT -> CACACCTCCTT
GCACCAACTAA -> CACCAACTAAT
GCACGGGAGCA -> CACGGGAGCAG
GCACGTCACTA -> CACGTCACTAG
GCAGAATTAGC -> CAGAATTAGCT
GCAGACTCAGC -> CAGACTCAGCC
GCAGATCCCAG -> CAGATCCCAGG
GCAGCATATTT -> CAGCATATTTG
GCAGGGTTATC -> CAGGGTTATCA
GCAGGTGATCT -> CAGGTGATCTA
GCAGTTTATGC -> CAGTTTATGCT
GCATACAGGCA -> CATACAGGCAT
GCATAGATCGC -> CATAGATCGCA
GCATAGGAAAG -> CATAGGAAAGT
GCATATTTGCC -> CATATTTGCCG
GCATCGGGAAC -> CATCGGGAACT
GCATGATTGTA -> CATGATTGTAC
GCATTCCCCTC -> CATTCCCCTCT
GCATTGCCACC -> CATTGCCACCC
GCATTTACGCT -> CATTTACGCTG
GCCAAACAGGA -> CCAAACAGGAT
GCCAATTTAGA -> CCAATTTAGAG
GCCACACACAA -> CCACACACAAT
GCCACCCACTG -> CCACCCACTGC
GCCACCTGCGC -> CCACCTGCGCC
GCCACTTGGAC -> CCACTTGGACG
GCCAGCATTGC -> CCAGCATTGCC
GCCAGTTCACA -> CCAGTTCACAA
GCCATCCGTCA -> CCATCCGTCAG
GCCATGTGGAG -> CCATGTGGAGG
GCCCAAAACCG -> CCCAAAACCGG
GCCCAGCCGAT -> CCCAGCCGATT
GCCCAGGTGTT -> CCCAGGTGTTA
GCCCATACCTA -> CCCATACCTAA
GCCCGGACAAC -> CCCGGACAACT
GCCCGGTTGAT -> CCCGGTTGATT
GCCCTGGCAAG -> CCCTGGCAAGC
GCCGATTGACA -> CCGATTGACAC
GCCGATTTTCG -> CCGATTTTCGC
GCCGCCACTTG -> CCGCCACTTGG
GCCGGACTGCC -> CCGGACTGCCT
GCCGGTGAAGC -> CCGGTGAAGCG
GCCGTACACTT -> CCGTACACTTG
GCCGTCCGCGG -> CCGTCCGCGGT
GCCTAGAGGGA -> CCTAGAGGGAC
GCCTAGTCCTA -> CCTAGTCCTAG
GCCTCGAAATA -> CCTCGAAATAT
GCCTCTAATTT -> CCTCTAATTTT
GCCTGCGTAGT -> CCTGCGTAGTT
GCCTTGACACT -> CCTTGACACTC
GCCTTTAAGAC -> CCTTTAAGACT
GCCTTTAGGGT -> CCTTTAGGGTT
GCGAAATATAT -> CGAAATATATC
GCGAGACACGG -> CGAGACACGGC
GCGAGCGAGAC -> CGAGCGAGACA
GCGAGGGATAA -> CGAGGGATAAT
GCGATCACCTC -> CGATCACCTCG
GCGATCTGCTG -> CGATCTGCTGG
GCGATTGCGTA -> CGATTGCGTAT
GCGCCACACAC -> CGCCACACACA
GCGCCCATACC -> CGCCCATACCT
GCGCGAAATAT -> CGCGAAATATA
GCGCGTTCTAT -> CGCGTTCTATG
GCGGCTAGTGC -> CGGCTAGTGCA
GCGGGTTAAAT -> CGGGTTAAATG
GCGGTGCCTCT -> CGGTGCCTCTA
GCGTAGTTTTT -> CGTAGTTTTTT
GCGTATACATC -> CGTATACATCG
GCGTGGAAATA -> CGTGGAAATAT
GCGTTATCTTC -> CGTTATCTTCG
GCGTTCTATGG -> CGTTCTATGGT
GCTAAGATGTA -> CTAAGATGTAA
GCTAATAATGA -> CTAATAATGAG
GCTAATCCTTG -> CTAATCCTTGT
GCTACCGTCCT -> CTACCGTCCTG
GCTAGCTAGCT -> CTAGCTAGCTT
GCTAGCTTACC -> CTAGCTTACCT
GCTAGTGCAAA -> CTAGTGCAAAC
GCTCCCCACAT -> CTCCCCACATG
GCTCCCGGATT -> CTCCCGGATTC
GCTCCTCTGTG -> CTCCTCTGTGG
GCTCTAATGAG -> CTCTAATGAGA
GCTCTCATTAA -> CTCTCATTAAC
GCTGAAAATTC -> CTGAAAATTCA
GCTGACTAGCA -> CTGACTAGCAA
GCTGAGGCCAG -> CTGAGGCCAGT
GCTGAGTAACC -> CTGAGTAACCT
GCTGCACGGGA -> CTGCACGGGAG
GCTGGGCATAG -> CTGGGCATAGG
GCTGGTCTAGT -> CTGGTCTAGTG
GCTTACCTCGG -> CTTACCTCGGA
GCTTACGGCCT -> CTTACGGCCTC
GCTTACTAGCC -> CTTACTAGCCG
GCTTAGTAGGC -> CTTAGTAGGCA
GCTTCAGTAAG -> CTTCAGTAAGA
GCTTGGCCAAT -> CTTGGCCAATT
GCTTGGTCAGC -> CTTGGTCAGCG
GCTTGTATTCA -> CTTGTATTCAT
GGAAAGTTCAA -> GAAAGTTCAAA
GGAAAGTTGGA -> GAAAGTTGGAT
GGAAATATTAT -> GAAATATTATG
GGAACCAGGGT -> GAACCAGGGTC
GGAACCCAATA -> GAACCCAATAC
GGAACTCATAA -> GAACTCATAAA
GGAAGTGCAAT -> GAAGTGCAATG
GGAATGGCTGC -> GAATGGCTGCA
GGACAACTCCT -> GACAACTCCTT
GGACATCATGT -> GACATCATGTC
GGACCATTGTC -> GACCATTGTCA
GGACCCTACAA -> GACCCTACAAG
GGACGGAAGTG -> GACGGAAGTGC
GGACGTGAGCA -> GACGTGAGCAG
GGACTATCGTG -> GACTATCGTGA
GGACTGCCTTT -> GACTGCCTTTA
GGAGCAGACTC -> GAGCAGACTCA
GGAGCAGCATA -> GAGCAGCATAT
GGAGCGGCTAG -> GAGCGGCTAGT
GGAGGCTAATA -> GAGGCTAATAA
GGAGTCTAGGC -> GAGTCTAGGCT
GGAGTCTCGGG -> GAGTCTCGGGA
GGATAATGCCA -> GATAATGCCAG
GGATACGCGAG -> GATACGCGAGC
GGATAGTATCA -> GATAGTATCAT
GGATCACGAGG -> GATCACGAGGG
GGATCCCTTAC -> GATCCCTTACA
GGATCCGCCCG -> GATCCGCCCGG
GGATCTCTATG -> GATCTCTATGG
GGATGACATCG -> GATGACATCGG
GGATGGAATGG -> GATGGAATGGC
GGATGTAAGGA -> GATGTAAGGAT
GGATTCCCAGA -> GATTCCCAGAG
GGATTGTGCCA -> GATTGTGCCAC
GGCAAACATTC -> GCAAACATTCT
GGCAAGCTTGG -> GCAAGCTTGGC
GGCACGTCACT -> GCACGTCACTA
GGCATACAGGC -> GCATACAGGCA
GGCATAGGAAA -> GCATAGGAAAG
GGCATCGGGAA -> GCATCGGGAAC
GGCATGATTGT -> GCATGATTGTA
GGCATTTACGC -> GCATTTACGCT
GGCCAATTTAG -> GCCAATTTAGA
GGCCAGTTCAC -> GCCAGTTCACA
GGCCATGTGGA -> GCCATGTGGAG
GGCCGTCCGCG -> GCCGTCCGCGG
GGCCTCGAAAT -> GCCTCGAAATA
GGCCTGCGTAG -> GCCTGCGTAGT
GGCCTTGACAC -> GCCTTGACACT
GGCGCGAAATA -> GCGCGAAATAT
GGCTAATAATG -> GCTAATAATGA
GGCTACCGTCC -> GCTACCGTCCT
GGCTAGTGCAA -> GCTAGTGCAAA
GGCTCCCGGAT -> GCTCCCGGATT
GGCTCCTCTGT -> GCTCCTCTGTG
GGCTGAAAATT -> GCTGAAAATTC
GGCTGCACGGG -> GCTGCACGGGA
GGCTGGGCATA -> GCTGGGCATAG
GGCTTACGGCC -> GCTTACGGCCT
GGCTTGGTCAG -> GCTTGGTCAGC
GGCTTGTATTC -> GCTTGTATTCA
GGGAACCAGGG -> GGAACCAGGGT
GGGAACTCATA -> GGAACTCATAA
GGGACCCTACA -> GGACCCTACAA
GGGACGTGAGC -> GGACGTGAGCA
GGGAGCAGCAT -> GGAGCAGCATA
GGGAGCGGCTA -> GGAGCGGCTAG
GGGAGTCTAGG -> GGAGTCTAGGC
GGGATAATGCC -> GGATAATGCCA
GGGATGACATC -> GGATGACATCG
GGGATGGAATG -> GGATGGAATGG
GGGCATAGGAA -> GGCATAGGAAA
GGGCCATGTGG -> GGCCATGTGGA
GGGCCTTGACA -> GGCCTTGACAC
GGGCTACCGTC -> GGCTACCGTCC
GGGCTCCCGGA -> GGCTCCCGGAT
GGGCTCCTCTG -> GGCTCCTCTGT
GGGCTGAAAAT -> GGCTGAAAATT
GGGCTTGGTCA -> GGCTTGGTCAG
GGGGCCATGTG -> GGGCCATGTGG
GGGGGTGCTAG -> GGGGTGCTAGC
GGGGTCAGATC -> GGGTCAGATCG
GGGGTGACATC -> GGGTGACATCT
GGGGTGCTAGC -> GGGTGCTAGCT
GGGTACGACAA -> GGTACGACAAC
GGGTCAATGGC -> GGTCAATGGCA
GGGTCAGATCG -> GGTCAGATCGG
GGGTCTATTAG -> GGTCTATTAGA
GGGTGACATCT -> GGTGACATCTA
GGGTGCTAGCT -> GGTGCTAGCTA
GGGTTAAATGG -> GGTTAAATGGT
GGGTTATCAAA -> GGTTATCAAAT
GGGTTCATCAT -> GGTTCATCATT
GGTACGACAAC -> GTACGACAACC
GGTATCATCTA -> GTATCATCTAA
GGTCAACTGCC -> GTCAACTGCCC
GGTCAATGGCA -> GTCAATGGCAC
GGTCACTGTAG -> GTCACTGTAGA
GGTCAGATCGG -> GTCAGATCGGT
GGTCAGCGCGT -> GTCAGCGCGTT
GGTCCCCGCCT -> GTCCCCGCCTA
GGTCGTAAGAC -> GTCGTAAGACT
GGTCTAACTAT -> GTCTAACTATT
GGTCTAGTGAC -> GTCTAGTGACA
GGTCTATTAGA -> GTCTATTAGAT
GGTCTTCTCAG -> GTCTTCTCAGA
GGTGAAGCGCC -> GTGAAGCGCCA
GGTGACATCTA -> GTGACATCTAG
GGTGATCTACC -> GTGATCTACCA
GGTGCCTCTAA -> GTGCCTCTAAT
GGTGCTAGCTA -> GTGCTAGCTAG
GGTGGATGTAA -> GTGGATGTAAG
GGTGGGATGGA -> GTGGGATGGAA
GGTGTGTACCT -> GTGTGTACCTG
GGTGTTACGAC -> GTGTTACGACA
GGTTAAATGGT -> GTTAAATGGTT
GGTTAAGGAGT -> GTTAAGGAGTC
GGTTAAGGCTT -> GTTAAGGCTTG
GGTTATCAAAT -> GTTATCAAATG
GGTTATGACGA -> GTTATGACGAC
GGTTCATCATT -> GTTCATCATTT
GGTTGATTTCT -> GTTGATTTCTT
GGTTGTGCTCC -> GTTGTGCTCCC
GTAAACCGCTT -> TAAACCGCTTA
GTAACCCGAGT -> TAACCCGAGTC
GTAACCTGTAT -> TAACCTGTATT
GTAACGTATAA -> TAACGTATAAG
GTAAGACTATG -> TAAGACTATGT
GTAAGAGAGAG -> TAAGAGAGAGA
GTAAGGATTGT -> TAAGGATTGTG
GTAAGGTTATG -> TAAGGTTATGA
GTACACTTGAG -> TACACTTGAGG
GTACCTGATAG -> TACCTGATAGT
GTACGACAACC -> TACGACAACCG
GTACGCAGATC -> TACGCAGATCC
GTACGTTCCGT -> TACGTTCCGTG
GTAGAAAATGA -> TAGAAAATGAA
GTAGACCAGAG -> TAGACCAGAGA
GTAGCATTCCC -> TAGCATTCCCC
GTAGGCATTTA -> TAGGCATTTAC
GTAGTTTTTTG -> TAGTTTTTTGG
GTATAAGACAT -> TATAAGACATA
GTATACATCGC -> TATACATCGCA
GTATCATCTAA -> TATCATCTAAG
GTATCATGCAG -> TATCATGCAGA
GTATCTGGGCT -> TATCTGGGCTC
GTATTCATAAT -> TATTCATAATG
GTATTGGGCTT -> TATTGGGCTTG
GTCAACACCCC -> TCAACACCCCC
GTCAACTGCCC -> TCAACTGCCCA
GTCAAGTGCAA -> TCAAGTGCAAA
GTCAAGTTGAT -> TCAAGTTGATG
GTCAATGGCAC -> TCAATGGCACG
GTCACGTAAAC -> TCACGTAAACC
GTCACTAGTGG -> TCACTAGTGGA
GTCACTGTAGA -> TCACTGTAGAC
GTCAGATCGGT -> TCAGATCGGTA
GTCAGCGCGTT -> TCAGCGCGTTC
GTCAGGCATGA -> TCAGGCATGAT
GTCAGTCATAG -> TCAGTCATAGG
GTCATAGGAAA -> TCATAGGAAAG
GTCCAATTATA -> TCCAATTATAG
GTCCCCGCCTA -> TCCCCGCCTAG
GTCCGCGGTGC -> TCCGCGGTGCC
GTCCGCTCTAA -> TCCGCTCTAAT
GTCCGTAGAAA -> TCCGTAGAAAA
GTCCTAGCTGA -> TCCTAGCTGAG
GTCCTCTCAAC -> TCCTCTCAACA
GTCCTGACCCT -> TCCTGACCCTA
GTCGAAGTGCA -> TCGAAGTGCAG
GTCGGCCTGCG -> TCGGCCTGCGT
GTCGGGAACCA -> TCGGGAACCAG
GTCGTAAGACT -> TCGTAAGACTA
GTCGTCCAATT -> TCGTCCAATTA
GTCTAACTATT -> TCTAACTATTT
GTCTACTGTGA -> TCTACTGTGAC
GTCTAGGCTTA -> TCTAGGCTTAC
GTCTAGTGACA -> TCTAGTGACAC
GTCTATTAGAT -> TCTATTAGATC
GTCTCCTCCCC -> TCTCCTCCCCG
GTCTCGGGATG -> TCTCGGGATGA
GTCTGTTGGAC -> TCTGTTGGACC
GTCTTCTCAGA -> TCTTCTCAGAG
GTGAAGCGCCA -> TGAAGCGCCAC
GTGACACTTTC -> TGACACTTTCG
GTGACAGATCC -> TGACAGATCCG
GTGACAGGATA -> TGACAGGATAC
GTGACATCTAG -> TGACATCTAGC
GTGACGCCTAG -> TGACGCCTAGT
GTGACTATGGT -> TGACTATGGTC
GTGAGCAGGTG -> TGAGCAGGTGA
GTGATCTACCA -> TGATCTACCAG
GTGCAAACTGC -> TGCAAACTGCC
GTGCAAAGAGT -> TGCAAAGAGTC
GTGCAATGCAG -> TGCAATGCAGT
GTGCAGGGTTA -> TGCAGGGTTAT
GTGCCACCTGC -> TGCCACCTGCG
GTGCCCGGTTG -> TGCCCGGTTGA
GTGCCTCTAAT -> TGCCTCTAATT
GTGCGATTGCG -> TGCGATTGCGT
GTGCTAGCTAG -> TGCTAGCTAGC
GTGCTCCCCAC -> TGCTCCCCACA
GTGCTCTCATT -> TGCTCTCATTA
GTGGAAATATT -> TGGAAATATTA
GTGGAGGCTAA -> TGGAGGCTAAT
GTGGATAGTAT -> TGGATAGTATC
GTGGATGTAAG -> TGGATGTAAGG
GTGGGACGTGA -> TGGGACGTGAG
GTGGGAGTCTA -> TGGGAGTCTAG
GTGGGATGGAA -> TGGGATGGAAT
GTGGGTCTATT -> TGGGTCTATTA
GTGTAAGGTTA -> TGTAAGGTTAT
GTGTACCTGAT -> TGTACCTGATA
GTGTGTACCTG -> TGTGTACCTGA
GTGTTACGACA -> TGTTACGACAC
GTGTTTCTCCA -> TGTTTCTCCAG
GTTAAATGGTT -> TTAAATGGTTA
GTTAAGGAGTC -> TTAAGGAGTCT
GTTAAGGCTTG -> TTAAGGCTTGT
GTTACACATGA -> TTACACATGAG
GTTACGACACC -> TTACGACACCG
GTTAGCCAAAC -> TTAGCCAAACA
GTTATCAAATG -> TTATCAAATGG
GTTATCTTCGT -> TTATCTTCGTC
GTTATGACGAC -> TTATGACGACG
GTTATTTGTGG -> TTATTTGTGGG
GTTCAAACCGC -> TTCAAACCGCC
GTTCACAAGTA -> TTCACAAGTAC
GTTCACAATTC -> TTCACAATTCG
GTTCATCATTT -> TTCATCATTTG
GTTCATCGACT -> TTCATCGACTT
GTTCCGTGACA -> TTCCGTGACAG
GTTCGTATCTG -> TTCGTATCTGG
GTTCTATGGTC -> TTCTATGGTCA
GTTGATGGAGC -> TTGATGGAGCA
GTTGATTTCTT -> TTGATTTCTTC
GTTGGACCATT -> TTGGACCATTG
GTTGGATCACG -> TTGGATCACGA
GTTGGGCTGAA -> TTGGGCTGAAA
GTTGTGCTCCC -> TTGTGCTCCCC
GTTTATGCTTA -> TTTATGCTTAG
GTTTCTCCAGG -> TTTCTCCAGGG
GTTTTTTGGTT -> TTTTTTGGTTG
TAAACCGCTTA -> AAACCGCTTAC
TAAATACAGCC -> AAATACAGCCG
TAAATGATACT -> AAATGATACTC
TAAATGGTTAA -> AAATGGTTAAG
TAACAACCTTA -> AACAACCTTAT
TAACACCTCAA -> AACACCTCAAC
TAACCCGAGTC -> AACCCGAGTCC
TAACCTGTATT -> AACCTGTATTG
TAACGACCTCG -> AACGACCTCGT
TAACGAGACAA -> AACGAGACAAC
TAACGCATAGA -> AACGCATAGAT
TAACGGCCGTC -> AACGGCCGTCC
TAACGTATAAG -> AACGTATAAGA
TAACTATTTGG -> AACTATTTGGG
TAACTCGTAAC -> AACTCGTAACG
TAAGAAGTGCC -> AAGAAGTGCCC
TAAGACATACT -> AAGACATACTG
TAAGACTATGT -> AAGACTATGTC
TAAGACTCGTC -> AAGACTCGTCC
TAAGACTGCCC -> AAGACTGCCCA
TAAGAGAGAGA -> AAGAGAGAGAC
TAAGATGTAAC -> AAGATGTAACC
TAAGGACTATC -> AAGGACTATCG
TAAGGAGTCTC -> AAGGAGTCTCG
TAAGGATTGTG -> AAGGATTGTGC
TAAGGCTTGTA -> AAGGCTTGTAT
TAAGGTTATGA -> AAGGTTATGAC
TAATAACGGCC -> AATAACGGCCG
TAATAATGAGC -> AATAATGAGCG
TAATCCTTGTT -> AATCCTTGTTC
TAATGAGACTG -> AATGAGACTGT
TAATGAGCGGG -> AATGAGCGGGT
TAATGCCAGCA -> AATGCCAGCAT
TAATGGAACCC -> AATGGAACCCA
TAATGTCAAGT -> AATGTCAAGTG
TAATTTTTCAT -> AATTTTTCATC
TACAAGTTATT -> ACAAGTTATTT
TACAATGACCG -> ACAATGACCGG
TACACATGAGC -> ACACATGAGCT
TACACTTGAGG -> ACACTTGAGGT
TACAGCCGTAC -> ACAGCCGTACA
TACAGGCATCG -> ACAGGCATCGG
TACATCCTGCG -> ACATCCTGCGT
TACATCGCACC -> ACATCGCACCA
TACATCTTTTT -> ACATCTTTTTC
TACATTCCCGG -> ACATTCCCGGG
TACCAGGGTAC -> ACCAGGGTACG
TACCGGGGCCA -> ACCGGGGCCAT
TACCGTCCTGA -> ACCGTCCTGAC
TACCTAACGAC -> ACCTAACGACC
TACCTCGGATC -> ACCTCGGATCC
TACCTGATAGT -> ACCTGATAGTC
TACGACAACCG -> ACGACAACCGT
TACGACACCGG -> ACGACACCGGG
TACGCAGATCC -> ACGCAGATCCC
TACGCGAGCGA -> ACGCGAGCGAG
TACGCTGAGTA -> ACGCTGAGTAA
TACGGCCTCGA -> ACGGCCTCGAA
TACGTTCCGTG -> ACGTTCCGTGA
TACTAGCCGGT -> ACTAGCCGGTG
TACTCCTACAA -> ACTCCTACAAT
TACTGAAGAGA -> ACTGAAGAGAT
TACTGTGACAG -> ACTGTGACAGA
TACTGTGTAAG -> ACTGTGTAAGG
TAGAAAATGAA -> AGAAAATGAAG
TAGAAACACTT -> AGAAACACTTA
TAGACCAGAGA -> AGACCAGAGAG
TAGAGAATTAA -> AGAGAATTAAG
TAGAGGGACCC -> AGAGGGACCCT
TAGATCGCAAC -> AGATCGCAACT
TAGATCGCAAT -> AGATCGCAATT
TAGCAAAAATT -> AGCAAAAATTG
TAGCATTCCCC -> AGCATTCCCCT
TAGCCAAACAG -> AGCCAAACAGG
TAGCCCAGCCG -> AGCCCAGCCGA
TAGCCGGTGAA -> AGCCGGTGAAG
TAGCTAAGATG -> AGCTAAGATGT
TAGCTAGCTTA -> AGCTAGCTTAC
TAGCTGAGGCC -> AGCTGAGGCCA
TAGCTTACCTC -> AGCTTACCTCG
TAGGAAAGTTC -> AGGAAAGTTCA
TAGGAAAGTTG -> AGGAAAGTTGG
TAGGACATCAT -> AGGACATCATG
TAGGCATTTAC -> AGGCATTTACG
TAGGCTTACGG -> AGGCTTACGGC
TAGGGTTCATC -> AGGGTTCATCA
TAGTAGGCATT -> AGTAGGCATTT
TAGTATCATGC -> AGTATCATGCA
TAGTCCTAGCT -> AGTCCTAGCTG
TAGTCTACTGT -> AGTCTACTGTG
TAGTGACACTT -> AGTGACACTTT
TAGTGCAAACT -> AGTGCAAACTG
TAGTGGATAGT -> AGTGGATAGTA
TAGTTTTTTGG -> AGTTTTTTGGT
TATAACTCGTA -> ATAACTCGTAA
TATAAGACATA -> ATAAGACATAC
TATACATCGCA -> ATACATCGCAC
TATAGGACATC -> ATAGGACATCA
TATATCCTCTA -> ATATCCTCTAA
TATATGTTGGG -> ATATGTTGGGC
TATCAAATGGT -> ATCAAATGGTG
TATCATCTAAG -> ATCATCTAAGG
TATCATGCAGA -> ATCATGCAGAA
TATCCTCTAAC -> ATCCTCTAACA
TATCGTGACGC -> ATCGTGACGCC
TATCTGGGCTC -> ATCTGGGCTCC
TATCTTCGTCT -> ATCTTCGTCTC
TATGAACTCGC -> ATGAACTCGCG
TATGACGACGT -> ATGACGACGTC
TATGAGTTACA -> ATGAGTTACAC
TATGCTTAGTA -> ATGCTTAGTAG
TATGGCGCGAA -> ATGGCGCGAAA
TATGGTCACTG -> ATGGTCACTGT
TATGGTCGTAA -> ATGGTCGTAAG
TATGGTCTAAC -> ATGGTCTAACT
TATGTCACGTA -> ATGTCACGTAA
TATGTTGGGCT -> ATGTTGGGCTG
TATTAGATCGC -> ATTAGATCGCA
TATTATGGCGC -> ATTATGGCGCG
TATTCATAATG -> ATTCATAATGT
TATTGGGCTTG -> ATTGGGCTTGG
TATTTGCCGAT -> ATTTGCCGATT
TATTTGGGGTC -> ATTTGGGGTCA
TATTTGTGGGA -> ATTTGTGGGAG
TATTTTGTTCA -> ATTTTGTTCAC
TCAAACCGCCT -> CAAACCGCCTT
TCAAATGAACG -> CAAATGAACGG
TCAAATGGTGG -> CAAATGGTGGG
TCAACACCCCC -> CAACACCCCCT
TCAACATTGTT -> CAACATTGTTA
TCAACCAATAC -> CAACCAATACC
TCAACTGCCCA -> CAACTGCCCAA
TCAAGTGCAAA -> CAAGTGCAAAG
TCAAGTTGATG -> CAAGTTGATGG
TCAATGGCACG -> CAATGGCACGT
TCACAAGTACG -> CACAAGTACGT
TCACAATTCGT -> CACAATTCGTG
TCACCTCGCTT -> CACCTCGCTTC
TCACGAGGGGG -> CACGAGGGGGT
TCACGTAAACC -> CACGTAAACCG
TCACTAGTGGA -> CACTAGTGGAT
TCACTGTAGAC -> CACTGTAGACC
TCAGAGTCGTC -> CAGAGTCGTCC
TCAGATCGGTA -> CAGATCGGTAT
TCAGCCGCCAC -> CAGCCGCCACT
TCAGCGCGTTC -> CAGCGCGTTCT
TCAGGCATGAT -> CAGGCATGATT
TCAGGTGGATG -> CAGGTGGATGT
TCAGTAAGAGA -> CAGTAAGAGAG
TCAGTCATAGG -> CAGTCATAGGA
TCATAAATACA -> CATAAATACAG
TCATAAGAAGT -> CATAAGAAGTG
TCATAATGTCA -> CATAATGTCAA
TCATAGGAAAG -> CATAGGAAAGT
TCATCATTTGG -> CATCATTTGGA
TCATCCTCCTT -> CATCCTCCTTA
TCATCGACTTC -> CATCGACTTCA
TCATCTAAGGA -> CATCTAAGGAC
TCATGCAGAAT -> CATGCAGAATT
TCATGTCGGGA -> CATGTCGGGAA
TCATTAACGCA -> CATTAACGCAT
TCATTTGGATC -> CATTTGGATCT
TCCAATTATAG -> CCAATTATAGG
TCCAGGGCCTT -> CCAGGGCCTTG
TCCAGGGCTAC -> CCAGGGCTACC
TCCCAGAGTGA -> CCCAGAGTGAC
TCCCAGGTGTG -> CCCAGGTGTGT
TCCCCACATGA -> CCCCACATGAC
TCCCCGCCTAG -> CCCCGCCTAGA
TCCCCGGCATA -> CCCCGGCATAC
TCCCCGTAGCA -> CCCCGTAGCAT
TCCCCTCTCCA -> CCCCTCTCCAG
TCCCGGATTCC -> CCCGGATTCCC
TCCCGGGGTGA -> CCCGGGGTGAC
TCCCTTACATT -> CCCTTACATTC
TCCGCCATCCG -> CCGCCATCCGT
TCCGCCCGGAC -> CCGCCCGGACA
TCCGCGGTGCC -> CCGCGGTGCCT
TCCGCTCTAAT -> CCGCTCTAATG
TCCGGTCCCCG -> CCGGTCCCCGC
TCCGTAGAAAA -> CCGTAGAAAAT
TCCGTCAGTCA -> CCGTCAGTCAT
TCCGTGACAGG -> CCGTGACAGGA
TCCGTGGGTCT -> CCGTGGGTCTA
TCCTACAATGA -> CCTACAATGAC
TCCTAGCTGAG -> CCTAGCTGAGG
TCCTCCCCGGC -> CCTCCCCGGCA
TCCTCCTTATG -> CCTCCTTATGA
TCCTCTAACAA -> CCTCTAACAAC
TCCTCTCAACA -> CCTCTCAACAT
TCCTCTGTGGG -> CCTCTGTGGGA
TCCTGACCCTA -> CCTGACCCTAC
TCCTGCGTTAT -> CCTGCGTTATC
TCCTGTCTGTT -> CCTGTCTGTTG
TCCTTAACACC -> CCTTAACACCT
TCCTTACTGAA -> CCTTACTGAAG
TCCTTATGAGT -> CCTTATGAGTT
TCCTTGTTCAT -> CCTTGTTCATC
TCCTTTCGCGT -> CCTTTCGCGTG
TCGAAATATAA -> CGAAATATAAC
TCGAAGTGCAG -> CGAAGTGCAGG
TCGACTTCAGG -> CGACTTCAGGT
TCGCAACTCCG -> CGCAACTCCGG
TCGCAATTCCC -> CGCAATTCCCC
TCGCACCAACT -> CGCACCAACTA
TCGCGAGGGAT -> CGCGAGGGATA
TCGCGTGGAAA -> CGCGTGGAAAT
TCGCTAATCCT -> CGCTAATCCTT
TCGCTTCAGTA -> CGCTTCAGTAA
TCGGATCCGCC -> CGGATCCGCCC
TCGGCCTGCGT -> CGGCCTGCGTA
TCGGGAACCAG -> CGGGAACCAGG
TCGGGAACTCA -> CGGGAACTCAT
TCGGGATGACA -> CGGGATGACAT
TCGGGCTCCTC -> CGGGCTCCTCT
TCGGTATCATC -> CGGTATCATCT
TCGTAACGTAT -> CGTAACGTATA
TCGTAAGACTA -> CGTAAGACTAT
TCGTATCTGGG -> CGTATCTGGGC
TCGTCAGGCAT -> CGTCAGGCATG
TCGTCCAATTA -> CGTCCAATTAT
TCGTCCGCTCT -> CGTCCGCTCTA
TCGTCTCCTCC -> CGTCTCCTCCC
TCGTGACGCCT -> CGTGACGCCTA
TCGTGCGATTG -> CGTGCGATTGC
TCGTGTTTCTC -> CGTGTTTCTCC
TCTAACAACCT -> CTAACAACCTT
TCTAACTATTT -> CTAACTATTTG
TCTAAGGACTA -> CTAAGGACTAT
TCTAATGAGAC -> CTAATGAGACT
TCTAATTTTTC -> CTAATTTTTCA
TCTACCAGGGT -> CTACCAGGGTA
TCTACTGTGAC -> CTACTGTGACA
TCTAGAAACAC -> CTAGAAACACT
TCTAGCCCAGC -> CTAGCCCAGCC
TCTAGGCTTAC -> CTAGGCTTACG
TCTAGTGACAC -> CTAGTGACACT
TCTATGGTCAC -> CTATGGTCACT
TCTATGGTCTA -> CTATGGTCTAA
TCTATTAGATC -> CTATTAGATCG
TCTCAACATTG -> CTCAACATTGT
TCTCAGAGTCG -> CTCAGAGTCGT
TCTCATTAACG -> CTCATTAACGC
TCTCCAGGGCC -> CTCCAGGGCCT
TCTCCAGGGCT -> CTCCAGGGCTA
TCTCCTCCCCG -> CTCCTCCCCGG
TCTCGGGATGA -> CTCGGGATGAC
TCTCTATGGTC -> CTCTATGGTCT
TCTGCTGGTCT -> CTGCTGGTCTA
TCTGGGCTCCC -> CTGGGCTCCCG
TCTGTGGGACG -> CTGTGGGACGT
TCTGTTGGACC -> CTGTTGGACCA
TCTTCAAATGA -> CTTCAAATGAA
TCTTCGTCTCC -> CTTCGTCTCCT
TCTTCTCAGAG -> CTTCTCAGAGT
TGAAAATTCAT -> GAAAATTCATA
TGAAACCCGAG -> GAAACCCGAGA
TGAACGGCAAA -> GAACGGCAAAC
TGAACTCGCGA -> GAACTCGCGAG
TGAAGAGATGC -> GAAGAGATGCC
TGAAGCACAAC -> GAAGCACAACA
TGAAGCGCCAC -> GAAGCGCCACA
TGACACTCCTG -> GACACTCCTGT
TGACACTCCTT -> GACACTCCTTT
TGACACTTATA -> GACACTTATAT
TGACACTTTCG -> GACACTTTCGT
TGACAGATCCG -> GACAGATCCGC
TGACAGGATAC -> GACAGGATACG
TGACATCGGGC -> GACATCGGGCT
TGACATCTAGC -> GACATCTAGCC
TGACCCTACAT -> GACCCTACATC
TGACCGGTCTT -> GACCGGTCTTC
TGACGACGTCG -> GACGACGTCGA
TGACGCCTAGT -> GACGCCTAGTC
TGACTAGCAAA -> GACTAGCAAAA
TGACTATGGTC -> GACTATGGTCG
TGAGACGCGAT -> GAGACGCGATC
TGAGACTGTCC -> GAGACTGTCCG
TGAGCAGGTGA -> GAGCAGGTGAT
TGAGCGGGTTA -> GAGCGGGTTAA
TGAGCTGACTA -> GAGCTGACTAG
TGAGGCCAGTT -> GAGGCCAGTTC
TGAGGTCAACT -> GAGGTCAACTG
TGAGTAACCTG -> GAGTAACCTGT
TGAGTTACACA -> GAGTTACACAT
TGATACTCCTA -> GATACTCCTAC
TGATAGTCTAC -> GATAGTCTACT
TGATCTACCAG -> GATCTACCAGG
TGATGGAGCAG -> GATGGAGCAGA
TGATTGTACGC -> GATTGTACGCA
TGATTTCTTCA -> GATTTCTTCAA
TGCAAACTGCC -> GCAAACTGCCG
TGCAAAGAGTC -> GCAAAGAGTCA
TGCAATGCAGT -> GCAATGCAGTT
TGCACACCTCC -> GCACACCTCCT
TGCACGGGAGC -> GCACGGGAGCA
TGCAGAATTAG -> GCAGAATTAGC
TGCAGGGTTAT -> GCAGGGTTATC
TGCAGTTTATG -> GCAGTTTATGC
TGCCACCCACT -> GCCACCCACTG
TGCCACCTGCG -> GCCACCTGCGC
TGCCAGCATTG -> GCCAGCATTGC
TGCCCAAAACC -> GCCCAAAACCG
TGCCCAGGTGT -> GCCCAGGTGTT
TGCCCGGTTGA -> GCCCGGTTGAT
TGCCCTGGCAA -> GCCCTGGCAAG
TGCCGATTTTC -> GCCGATTTTCG
TGCCGGACTGC -> GCCGGACTGCC
TGCCTCTAATT -> GCCTCTAATTT
TGCCTTTAAGA -> GCCTTTAAGAC
TGCGATTGCGT -> GCGATTGCGTA
TGCGCCCATAC -> GCGCCCATACC
TGCGTAGTTTT -> GCGTAGTTTTT
TGCGTATACAT -> GCGTATACATC
TGCGTTATCTT -> GCGTTATCTTC
TGCTAGCTAGC -> GCTAGCTAGCT
TGCTCCCCACA -> GCTCCCCACAT
TGCTCTCATTA -> GCTCTCATTAA
TGCTGGTCTAG -> GCTGGTCTAGT
TGCTTAGTAGG -> GCTTAGTAGGC
TGGAAATATTA -> GGAAATATTAT
TGGAACCCAAT -> GGAACCCAATA
TGGAATGGCTG -> GGAATGGCTGC
TGGACCATTGT -> GGACCATTGTC
TGGACGGAAGT -> GGACGGAAGTG
TGGAGCAGACT -> GGAGCAGACTC
TGGAGGCTAAT -> GGAGGCTAATA
TGGATAGTATC -> GGATAGTATCA
TGGATCACGAG -> GGATCACGAGG
TGGATCTCTAT -> GGATCTCTATG
TGGATGTAAGG -> GGATGTAAGGA
TGGCAAGCTTG -> GGCAAGCTTGG
TGGCACGTCAC -> GGCACGTCACT
TGGCCAATTTA -> GGCCAATTTAG
TGGCGCGAAAT -> GGCGCGAAATA
TGGCTGCACGG -> GGCTGCACGGG
TGGGACGTGAG -> GGGACGTGAGC
TGGGAGTCTAG -> GGGAGTCTAGG
TGGGATGGAAT -> GGGATGGAATG
TGGGCATAGGA -> GGGCATAGGAA
TGGGCTCCCGG -> GGGCTCCCGGA
TGGGCTGAAAA -> GGGCTGAAAAT
TGGGCTTGGTC -> GGGCTTGGTCA
TGGGGTCAGAT -> GGGGTCAGATC
TGGGTCTATTA -> GGGTCTATTAG
TGGTCACTGTA -> GGTCACTGTAG
TGGTCAGCGCG -> GGTCAGCGCGT
TGGTCGTAAGA -> GGTCGTAAGAC
TGGTCTAACTA -> GGTCTAACTAT
TGGTCTAGTGA -> GGTCTAGTGAC
TGGTGGGATGG -> GGTGGGATGGA
TGGTTAAGGAG -> GGTTAAGGAGT
TGGTTGTGCTC -> GGTTGTGCTCC
TGTAACCCGAG -> GTAACCCGAGT
TGTAAGGATTG -> GTAAGGATTGT
TGTAAGGTTAT -> GTAAGGTTATG
TGTACCTGATA -> GTACCTGATAG
TGTACGCAGAT -> GTACGCAGATC
TGTAGACCAGA -> GTAGACCAGAG
TGTATTCATAA -> GTATTCATAAT
TGTATTGGGCT -> GTATTGGGCTT
TGTCAACACCC -> GTCAACACCCC
TGTCAAGTGCA -> GTCAAGTGCAA
TGTCACGTAAA -> GTCACGTAAAC
TGTCCGTAGAA -> GTCCGTAGAAA
TGTCGGGAACC -> GTCGGGAACCA
TGTCTGTTGGA -> GTCTGTTGGAC
TGTGACAGATC -> GTGACAGATCC
TGTGCCACCTG -> GTGCCACCTGC
TGTGCTCCCCA -> GTGCTCCCCAC
TGTGGAGGCTA -> GTGGAGGCTAA
TGTGGGACGTG -> GTGGGACGTGA
TGTGGGAGTCT -> GTGGGAGTCTA
TGTGTAAGGTT -> GTGTAAGGTTA
TGTGTACCTGA -> GTGTACCTGAT
TGTTACGACAC -> GTTACGACACC
TGTTAGCCAAA -> GTTAGCCAAAC
TGTTCACAAGT -> GTTCACAAGTA
TGTTCATCGAC -> GTTCATCGACT
TGTTGGACCAT -> GTTGGACCATT
TGTTGGGCTGA -> GTTGGGCTGAA
TGTTTCTCCAG -> GTTTCTCCAGG
TTAAATGGTTA -> TAAATGGTTAA
TTAACACCTCA -> TAACACCTCAA
TTAACGCATAG -> TAACGCATAGA
TTAAGACTCGT -> TAAGACTCGTC
TTAAGACTGCC -> TAAGACTGCCC
TTAAGGAGTCT -> TAAGGAGTCTC
TTAAGGCTTGT -> TAAGGCTTGTA
TTAATGGAACC -> TAATGGAACCC
TTACACATGAG -> TACACATGAGC
TTACATTCCCG -> TACATTCCCGG
TTACCTCGGAT -> TACCTCGGATC
TTACGACACCG -> TACGACACCGG
TTACGCTGAGT -> TACGCTGAGTA
TTACGGCCTCG -> TACGGCCTCGA
TTACTAGCCGG -> TACTAGCCGGT
TTACTGAAGAG -> TACTGAAGAGA
TTAGAGAATTA -> TAGAGAATTAA
TTAGATCGCAA -> TAGATCGCAAT
TTAGCCAAACA -> TAGCCAAACAG
TTAGCTAAGAT -> TAGCTAAGATG
TTAGGGTTCAT -> TAGGGTTCATC
TTAGTAGGCAT -> TAGTAGGCATT
TTATAGGACAT -> TATAGGACATC
TTATATGTTGG -> TATATGTTGGG
TTATCAAATGG -> TATCAAATGGT
TTATCTTCGTC -> TATCTTCGTCT
TTATGAACTCG -> TATGAACTCGC
TTATGACGACG -> TATGACGACGT
TTATGAGTTAC -> TATGAGTTACA
TTATGCTTAGT -> TATGCTTAGTA
TTATGGCGCGA -> TATGGCGCGAA
TTATTTGTGGG -> TATTTGTGGGA
TTCAAACCGCC -> TCAAACCGCCT
TTCAAATGAAC -> TCAAATGAACG
TTCACAAGTAC -> TCACAAGTACG
TTCACAATTCG -> TCACAATTCGT
TTCAGGTGGAT -> TCAGGTGGATG
TTCAGTAAGAG -> TCAGTAAGAGA
TTCATAAGAAG -> TCATAAGAAGT
TTCATAATGTC -> TCATAATGTCA
TTCATCATTTG -> TCATCATTTGG
TTCATCCTCCT -> TCATCCTCCTT
TTCATCGACTT -> TCATCGACTTC
TTCCCAGAGTG -> TCCCAGAGTGA
TTCCCCGTAGC -> TCCCCGTAGCA
TTCCCCTCTCC -> TCCCCTCTCCA
TTCCCGGGGTG -> TCCCGGGGTGA
TTCCGTGACAG -> TCCGTGACAGG
TTCCGTGGGTC -> TCCGTGGGTCT
TTCGCGTGGAA -> TCGCGTGGAAA
TTCGCTAATCC -> TCGCTAATCCT
TTCGTATCTGG -> TCGTATCTGGG
TTCGTCAGGCA -> TCGTCAGGCAT
TTCGTCTCCTC -> TCGTCTCCTCC
TTCGTGTTTCT -> TCGTGTTTCTC
TTCTAGAAACA -> TCTAGAAACAC
TTCTATGGTCA -> TCTATGGTCAC
TTCTCAGAGTC -> TCTCAGAGTCG
TTCTCCAGGGC -> TCTCCAGGGCT
TTCTTCAAATG -> TCTTCAAATGA
TTGACACTCCT -> TGACACTCCTT
TTGACACTTAT -> TGACACTTATA
TTGAGACGCGA -> TGAGACGCGAT
TTGAGGTCAAC -> TGAGGTCAACT
TTGATGGAGCA -> TGATGGAGCAG
TTGATTTCTTC -> TGATTTCTTCA
TTGCCACCCAC -> TGCCACCCACT
TTGCCGATTTT -> TGCCGATTTTC
TTGCGTATACA -> TGCGTATACAT
TTGGACCATTG -> TGGACCATTGT
TTGGACGGAAG -> TGGACGGAAGT
TTGGATCACGA -> TGGATCACGAG
TTGGATCTCTA -> TGGATCTCTAT
TTGGCCAATTT -> TGGCCAATTTA
TTGGGCTGAAA -> TGGGCTGAAAA
TTGGGCTTGGT -> TGGGCTTGGTC
TTGGGGTCAGA -> TGGGGTCAGAT
TTGGTCAGCGC -> TGGTCAGCGCG
TTGGTTGTGCT -> TGGTTGTGCTC
TTGTACGCAGA -> TGTACGCAGAT
TTGTATTCATA -> TGTATTCATAA
TTGTCAACACC -> TGTCAACACCC
TTGTGCCACCT -> TGTGCCACCTG
TTGTGCTCCCC -> TGTGCTCCCCA
TTGTGGGAGTC -> TGTGGGAGTCT
TTGTTAGCCAA -> TGTTAGCCAAA
TTGTTCACAAG -> TGTTCACAAGT
TTGTTCATCGA -> TGTTCATCGAC
TTTAAGACTCG -> TTAAGACTCGT
TTTACGCTGAG -> TTACGCTGAGT
TTTAGAGAATT -> TTAGAGAATTA
TTTAGGGTTCA -> TTAGGGTTCAT
TTTATGCTTAG -> TTATGCTTAGT
TTTCATCCTCC -> TTCATCCTCCT
TTTCGCGTGGA -> TTCGCGTGGAA
TTTCGCTAATC -> TTCGCTAATCC
TTTCGTCAGGC -> TTCGTCAGGCA
TTTCTCCAGGG -> TTCTCCAGGGC
TTTCTTCAAAT -> TTCTTCAAATG
TTTGCCGATTT -> TTGCCGATTTT
TTTGGATCTCT -> TTGGATCTCTA
TTTGGGGTCAG -> TTGGGGTCAGA
TTTGGTTGTGC -> TTGGTTGTGCT
TTTGTGGGAGT -> TTGTGGGAGTC
TTTGTTCACAA -> TTGTTCACAAG
TTTTCATCCTC -> TTTCATCCTCC
TTTTCGCTAAT -> TTTCGCTAATC
TTTTGGTTGTG -> TTTGGTTGTGC
TTTTGTTCACA -> TTTGTTCACAA
TTTTTCATCCT -> TTTTCATCCTC
TTTTTGGTTGT -> TTTTGGTTGTG
TTTTTTGGTTG -> TTTTTGGTTGT
