AAAAAATCAAGACGCAGTT -> AAAAATCAAGACGCAGTTT
AAAAATAGGAGCTATGTGA -> AAAATAGGAGCTATGTGAG
AAAAATCAAGACGCAGTTT -> AAAATCAAGACGCAGTTTC
AAAACCCCGGAGCTTTCGG -> AAACCCCGGAGCTTTCGGA
AAAACTAGTATCTTACTTT -> AAACTAGTATCTTACTTTC
AAAAGACTTTGATGGTGTG -> AAAGACTTTGATGGTGTGT
AAAATAGGAGCTATGTGAG -> AAATAGGAGCTATGTGAGA
AAAATCAAGACGCAGTTTC -> AAATCAAGACGCAGTTTCA
AAACACTGTAAGCATTCGA -> AACACTGTAAGCATTCGAG
AAACCATCGTTTAGGGGGA -> AACCATCGTTTAGGGGGAT
AAACCCCGGAGCTTTCGGA -> AACCCCGGAGCTTTCGGAT
AAACTAGTATCTTACTTTC -> AACTAGTATCTTACTTTCA
AAACTATTTAACCGGGATC -> AACTATTTAACCGGGATCG
AAAGACTTTGATGGTGTGT -> AAGACTTTGATGGTGTGTC
AAAGAGAGCCTCTAAGGGA -> AAGAGAGCCTCTAAGGGAA
AAAGATCGATGCAAGCTAC -> AAGATCGATGCAAGCTACA
AAAGGCCCCGTCCTGTGAC -> AAGGCCCCGTCCTGTGACG
AAAGGGTGAATCCCATAAA -> AAGGGTGAATCCCATAAAA
AAATAAATGCAGAGTAGCG -> AATAAATGCAGAGTAGCGT
AAATAGGAGCTATGTGAGA -> AATAGGAGCTATGTGAGAT
AAATATCGATATGTACACA -> AATATCGATATGTACACAT
AAATATGTACGTTATTGCC -> AATATGTACGTTATTGCCG
AAATCAAGACGCAGTTTCA -> AATCAAGACGCAGTTTCAC
AAATCTTGGATACAATAGG -> AATCTTGGATACAATAGGG
AAATCTTGGCCAATCGCCC -> AATCTTGGCCAATCGCCCT
AAATCTTGTCCGCAAGCTG -> AATCTTGTCCGCAAGCTGA
AAATCTTGTTGGTTCCTGT -> AATCTTGTTGGTTCCTGTC
AAATGCAGAGTAGCGTCTG -> AATGCAGAGTAGCGTCTGT
AAATGTCGCTTCTTGCCAC -> AATGTCGCTTCTTGCCACT
AAATTCTTTAATGTCCTCG -> AATTCTTTAATGTCCTCGA
AACACTGTAAGCATTCGAG -> ACACTGTAAGCATTCGAGG
AACAGAGTCCAAGGGCCCA -> ACAGAGTCCAAGGGCCCAT
AACAGCTGCACGCCGTGAC -> ACAGCTGCACGCCGTGACT
AACATGCCAATCTCCTAGC -> ACATGCCAATCTCCTAGCG
AACATGCGTCTATAGTCCA -> ACATGCGTCTATAGTCCAA
AACCACAGTGGCTGGCTAA -> ACCACAGTGGCTGGCTAAA
AACCATCGTTTAGGGGGAT -> ACCATCGTTTAGGGGGATG
AACCCCGGAGCTTTCGGAT -> ACCCCGGAGCTTTCGGATA
AACCCTGCACTATCATCCA -> ACCCTGCACTATCATCCAG
AACCGGGATCGTTACACTG -> ACCGGGATCGTTACACTGA
AACCGGGTGACCCTTAAAT -> ACCGGGTGACCCTTAAATA
AACGAGCTGTCGAGGGAGT -> ACGAGCTGTCGAGGGAGTA
AACGCCAAGGCCTACGAAA -> ACGCCAAGGCCTACGAAAT
AACGGCGCCTACTTGCCGT -> ACGGCGCCTACTTGCCGTC
AACGGGACGAACTTATACG -> ACGGGACGAACTTATACGA
AACGGTGCAGGAACGCCAA -> ACGGTGCAGGAACGCCAAG
AACGTGCTCGGATGACATG -> ACGTGCTCGGATGACATGT
AACTACGAACGTGCTCGGA -> ACTACGAACGTGCTCGGAT
AACTAGCCTGTCCTAAAGG -> ACTAGCCTGTCCTAAAGGG
AACTAGTATCTTACTTTCA -> ACTAGTATCTTACTTTCAC
AACTATTTAACCGGGATCG -> ACTATTTAACCGGGATCGT
AACTCTGTGTGATGCATAG -> ACTCTGTGTGATGCATAGC
AACTGTGGATTTAAGCTTT -> ACTGTGGATTTAAGCTTTG
AACTTATACGATCCCAATC -> ACTTATACGATCCCAATCA
AACTTATACGATCCCACAC -> ACTTATACGATCCCACACC
AACTTATACGATCCCAGTT -> ACTTATACGATCCCAGTTG
AACTTATACGATCCCATTG -> ACTTATACGATCCCATTGG
AACTTGTTCTACATTGAAC -> ACTTGTTCTACATTGAACG
AAGAAATAAATGCAGAGTA -> AGAAATAAATGCAGAGTAG
AAGACCAATGGAGGGTTAA -> AGACCAATGGAGGGTTAAA
AAGACGCAGTTTCACGGCT -> AGACGCAGTTTCACGGCTT
AAGACTTTGATGGTGTGTC -> AGACTTTGATGGTGTGTCG
AAGAGAGCCTCTAAGGGAA -> AGAGAGCCTCTAAGGGAAT
AAGAGAGGCTGCCCTGTAT -> AGAGAGGCTGCCCTGTATA
AAGAGATCAGTTTGTCACC -> AGAGATCAGTTTGTCACCC
AAGAGGCCTGCGGCTAAAG -> AGAGGCCTGCGGCTAAAGA
AAGATCGATGCAAGCTACA -> AGATCGATGCAAGCTACAC
AAGCATTCGAGGATTCCCC -> AGCATTCGAGGATTCCCCC
AAGCCATTTCCTCTCGTCG -> AGCCATTTCCTCTCGTCGT
AAGCCTTACTGACAGAGAA -> AGCCTTACTGACAGAGAAT
AAGCGTGCTGACAGTGGGG -> AGCGTGCTGACAGTGGGGT
AAGCTACACTTGGAGCAGT -> AGCTACACTTGGAGCAGTG
AAGCTGATCGCAAAGAGAG -> AGCTGATCGCAAAGAGAGC
AAGCTTTGACCCCGTATCC -> AGCTTTGACCCCGTATCCC
AAGGACATGGAATCTTGGC -> AGGACATGGAATCTTGGCC
AAGGACCATCATCAGGATT -> AGGACCATCATCAGGATTG
AAGGCCCCGTCCTGTGACG -> AGGCCCCGTCCTGTGACGG
AAGGCCTACGAAATTCTTT -> AGGCCTACGAAATTCTTTA
AAGGGAATATCGGGTCAAA -> AGGGAATATCGGGTCAAAA
AAGGGCCCATTGGTACGGT -> AGGGCCCATTGGTACGGTG
AAGGGTGAATCCCATAAAA -> AGGGTGAATCCCATAAAAG
AAGGTCAACCGGGTGACCC -> AGGTCAACCGGGTGACCCT
AAGGTCAAGGTCAACCGGG -> AGGTCAAGGTCAACCGGGT
AAGTAACTCTGTGTGATGC -> AGTAACTCTGTGTGATGCA
AAGTCTCATTTGCGTACGG -> AGTCTCATTTGCGTACGGG
AAGTGGCTGGCTAAATCTT -> AGTGGCTGGCTAAATCTTG
AATAAATGCAGAGTAGCGT -> ATAAATGCAGAGTAGCGTC
AATAGGACTATTCGTCATG -> ATAGGACTATTCGTCATGA
AATAGGAGCTATGTGAGAT -> ATAGGAGCTATGTGAGATA
AATAGGGAGGAATCGCAGA -> ATAGGGAGGAATCGCAGAC
AATATCAGTGGCTGGCTAA -> ATATCAGTGGCTGGCTAAA
AATATCGATATGTACACAT -> ATATCGATATGTACACATG
AATATCGGGTCAAAACTAG -> ATATCGGGTCAAAACTAGT
AATATGTACGTTATTGCCG -> ATATGTACGTTATTGCCGT
AATCAAGACGCAGTTTCAC -> ATCAAGACGCAGTTTCACG
AATCATAATATCAGTGGCT -> ATCATAATATCAGTGGCTG
AATCCCATAAAAGACTTTG -> ATCCCATAAAAGACTTTGA
AATCCCCACGGGAGGTGTC -> ATCCCCACGGGAGGTGTCA
AATCCTAATCCCCACGGGA -> ATCCTAATCCCCACGGGAG
AATCGCAGACGCCCTACGA -> ATCGCAGACGCCCTACGAT
AATCGCCCTTACTTGAAGT -> ATCGCCCTTACTTGAAGTC
AATCGCCGAGACTTTTTAA -> ATCGCCGAGACTTTTTAAG
AATCGTCACTTCTCGGTTG -> ATCGTCACTTCTCGGTTGT
AATCGTGGGAATGTTGTGG -> ATCGTGGGAATGTTGTGGT
AATCTCCTAGCGCTAGTCA -> ATCTCCTAGCGCTAGTCAT
AATCTGGAACTCAGGGGGG -> ATCTGGAACTCAGGGGGGA
AATCTTGGATACAATAGGG -> ATCTTGGATACAATAGGGA
AATCTTGGCCAATCGCCCT -> ATCTTGGCCAATCGCCCTT
AATCTTGGCCCTATCGGTG -> ATCTTGGCCCTATCGGTGC
AATCTTGTCCGCAAGCTGA -> ATCTTGTCCGCAAGCTGAT
AATCTTGTTGGTTCCTGTC -> ATCTTGTTGGTTCCTGTCT
AATGAAAGGCCCCGTCCTG -> ATGAAAGGCCCCGTCCTGT
AATGAGCAACGAGCTGTCG -> ATGAGCAACGAGCTGTCGA
AATGAGTTTAATTTTAAGG -> ATGAGTTTAATTTTAAGGA
AATGATATGCGTAGTATTG -> ATGATATGCGTAGTATTGA
AATGCAGAGTAGCGTCTGT -> ATGCAGAGTAGCGTCTGTC
AATGGAGGGTTAAACTATT -> ATGGAGGGTTAAACTATTT
AATGGGAGCACGGTCCGCG -> ATGGGAGCACGGTCCGCGG
AATGTCCTCGAACTTATAC -> ATGTCCTCGAACTTATACG
AATGTCGCTTCTTGCCACT -> ATGTCGCTTCTTGCCACTC
AATGTTGTGGTTCCCTCTT -> ATGTTGTGGTTCCCTCTTA
AATTCTTTAATGTCCTCGA -> ATTCTTTAATGTCCTCGAA
AATTGCTCCAGGCATTCCA -> ATTGCTCCAGGCATTCCAT
AATTTTAAGGACATGGAAT -> ATTTTAAGGACATGGAATC
ACAAAAATAGGAGCTATGT -> CAAAAATAGGAGCTATGTG
ACAACAGCTGCACGCCGTG -> CAACAGCTGCACGCCGTGA
ACAACTTGTTCTACATTGA -> CAACTTGTTCTACATTGAA
ACAAGACCAATGGAGGGTT -> CAAGACCAATGGAGGGTTA
ACAAGAGGCCTGCGGCTAA -> CAAGAGGCCTGCGGCTAAA
ACAATAGGGAGGAATCGCA -> CAATAGGGAGGAATCGCAG
ACACATGGAACTACGAACG -> CACATGGAACTACGAACGT
ACACCCACAGTTACCCCTA -> CACCCACAGTTACCCCTAG
ACACCCGACATCCACGCAC -> CACCCGACATCCACGCACA
ACACCCTCAGGTTAAATGT -> CACCCTCAGGTTAAATGTC
ACACCTGCGGTCAGTGGCT -> CACCTGCGGTCAGTGGCTG
ACACGCGTGCGAGGATGGC -> CACGCGTGCGAGGATGGCT
ACACTGATGATGATCGCTA -> CACTGATGATGATCGCTAG
ACACTGCCAGACACCCTCA -> CACTGCCAGACACCCTCAG
ACACTGTAAGCATTCGAGG -> CACTGTAAGCATTCGAGGA
ACACTGTGCCACTATTATC -> CACTGTGCCACTATTATCC
ACACTTGGAGCAGTGATAT -> CACTTGGAGCAGTGATATC
ACAGAAAACCCCGGAGCTT -> CAGAAAACCCCGGAGCTTT
ACAGACCAATGGGAGCACG -> CAGACCAATGGGAGCACGG
ACAGAGAATCGCCGAGACT -> CAGAGAATCGCCGAGACTT
ACAGAGTCCAAGGGCCCAT -> CAGAGTCCAAGGGCCCATT
ACAGCTGCACGCCGTGACT -> CAGCTGCACGCCGTGACTA
ACAGGCGCACGGATACTCG -> CAGGCGCACGGATACTCGA
ACAGGTCAGTCAGTGGAAG -> CAGGTCAGTCAGTGGAAGC
ACAGTGGCTGGCTAAATCT -> CAGTGGCTGGCTAAATCTT
ACAGTGGGGTGAAGGACCA -> CAGTGGGGTGAAGGACCAT
ACAGTTACCCCTAGGGACA -> CAGTTACCCCTAGGGACAG
ACATCCACGCACAAGAGGC -> CATCCACGCACAAGAGGCC
ACATGCCAATCTCCTAGCG -> CATGCCAATCTCCTAGCGC
ACATGCGTCTATAGTCCAA -> CATGCGTCTATAGTCCAAT
ACATGGAACTACGAACGTG -> CATGGAACTACGAACGTGC
ACATGGAATCTTGGCCCTA -> CATGGAATCTTGGCCCTAT
ACATGTTGAGTATCTGATA -> CATGTTGAGTATCTGATAA
ACATTGAACGGGACGAACT -> CATTGAACGGGACGAACTT
ACCAATGGAGGGTTAAACT -> CCAATGGAGGGTTAAACTA
ACCAATGGGAGCACGGTCC -> CCAATGGGAGCACGGTCCG
ACCACAGTGGCTGGCTAAA -> CCACAGTGGCTGGCTAAAT
ACCATCATCAGGATTGCGT -> CCATCATCAGGATTGCGTT
ACCATCGTTTAGGGGGATG -> CCATCGTTTAGGGGGATGG
ACCCACAGTTACCCCTAGG -> CCCACAGTTACCCCTAGGG
ACCCAGCTAGTCTCACTTG -> CCCAGCTAGTCTCACTTGG
ACCCCCCGAATAGGACTAT -> CCCCCCGAATAGGACTATT
ACCCCGGAGCTTTCGGATA -> CCCCGGAGCTTTCGGATAT
ACCCCGTATCCCCTGCTGC -> CCCCGTATCCCCTGCTGCT
ACCCCTAGGGACAGGTCAG -> CCCCTAGGGACAGGTCAGT
ACCCGAAGTAACTCTGTGT -> CCCGAAGTAACTCTGTGTG
ACCCGACATCCACGCACAA -> CCCGACATCCACGCACAAG
ACCCTCAGGTTAAATGTCG -> CCCTCAGGTTAAATGTCGC
ACCCTGCACTATCATCCAG -> CCCTGCACTATCATCCAGC
ACCCTTAAATATGTACGTT -> CCCTTAAATATGTACGTTA
ACCGAGGGACTAAGAGATC -> CCGAGGGACTAAGAGATCA
ACCGGGATCGTTACACTGA -> CCGGGATCGTTACACTGAT
ACCGGGTGACCCTTAAATA -> CCGGGTGACCCTTAAATAT
ACCGGTCTCTGTGGAGCTC -> CCGGTCTCTGTGGAGCTCC
ACCTACGGGGAACCCTGCA -> CCTACGGGGAACCCTGCAC
ACCTCTCGCTTCGATTACG -> CCTCTCGCTTCGATTACGC
ACCTGCGGTCAGTGGCTGG -> CCTGCGGTCAGTGGCTGGC
ACCTTATTTAATGAGTTTA -> CCTTATTTAATGAGTTTAA
ACGAAATTCTTTAATGTCC -> CGAAATTCTTTAATGTCCT
ACGAACGTGCTCGGATGAC -> CGAACGTGCTCGGATGACA
ACGAACTTATACGATCCCA -> CGAACTTATACGATCCCAA
ACGACGAGCTAACTAGCCT -> CGACGAGCTAACTAGCCTG
ACGAGCTAACTAGCCTGTC -> CGAGCTAACTAGCCTGTCC
ACGAGCTGTCGAGGGAGTA -> CGAGCTGTCGAGGGAGTAC
ACGATCCCAATCATAATAT -> CGATCCCAATCATAATATC
ACGATCCCACACCTGCGGT -> CGATCCCACACCTGCGGTC
ACGATCCCAGTTGTGATTT -> CGATCCCAGTTGTGATTTA
ACGATCCCATTGGCAACCA -> CGATCCCATTGGCAACCAC
ACGATCGGTTTTGCCCCAG -> CGATCGGTTTTGCCCCAGG
ACGATTGCGAACTTATACG -> CGATTGCGAACTTATACGA
ACGCACAAGAGGCCTGCGG -> CGCACAAGAGGCCTGCGGC
ACGCAGTTTCACGGCTTTT -> CGCAGTTTCACGGCTTTTG
ACGCCAAGGCCTACGAAAT -> CGCCAAGGCCTACGAAATT
ACGCCCTACGATCGGTTTT -> CGCCCTACGATCGGTTTTG
ACGCCGTGACTATTAGTGG -> CGCCGTGACTATTAGTGGA
ACGCGCGTACAACTTGTTC -> CGCGCGTACAACTTGTTCT
ACGCGTGCGAGGATGGCTT -> CGCGTGCGAGGATGGCTTA
ACGCGTTGCATCACTTTCT -> CGCGTTGCATCACTTTCTG
ACGCTTTATTGTAGTGGAT -> CGCTTTATTGTAGTGGATG
ACGGATACTCGACTGCGGC -> CGGATACTCGACTGCGGCG
ACGGCAATCCTAATCCCCA -> CGGCAATCCTAATCCCCAC
ACGGCGCCTACTTGCCGTC -> CGGCGCCTACTTGCCGTCC
ACGGCTTTTGTAGCAAGAA -> CGGCTTTTGTAGCAAGAAA
ACGGGACGAACTTATACGA -> CGGGACGAACTTATACGAT
ACGGGAGGTGTCAGTCCTA -> CGGGAGGTGTCAGTCCTAG
ACGGGCAAGGTCAAGGTCA -> CGGGCAAGGTCAAGGTCAA
ACGGGGAACCCTGCACTAT -> CGGGGAACCCTGCACTATC
ACGGTCCGCGGAGTAAGCG -> CGGTCCGCGGAGTAAGCGT
ACGGTCTCCATTTCGGTGA -> CGGTCTCCATTTCGGTGAT
ACGGTGACTATTCTCACGG -> CGGTGACTATTCTCACGGT
ACGGTGCAGGAACGCCAAG -> CGGTGCAGGAACGCCAAGG
ACGTCAGGACACCCACAGT -> CGTCAGGACACCCACAGTT
ACGTGCTCGGATGACATGT -> CGTGCTCGGATGACATGTT
ACGTGTAGTGTACGATTGC -> CGTGTAGTGTACGATTGCG
ACGTTATTGCCGTGTCGCC -> CGTTATTGCCGTGTCGCCG
ACTAAGAGATCAGTTTGTC -> CTAAGAGATCAGTTTGTCA
ACTACGAACGTGCTCGGAT -> CTACGAACGTGCTCGGATG
ACTAGCCTGTCCTAAAGGG -> CTAGCCTGTCCTAAAGGGT
ACTAGTATCTTACTTTCAC -> CTAGTATCTTACTTTCACC
ACTATCATCCAGCCCGTCG -> CTATCATCCAGCCCGTCGT
ACTATGAACTGTGGATTTA -> CTATGAACTGTGGATTTAA
ACTATTAGTGGACGCTTTA -> CTATTAGTGGACGCTTTAT
ACTATTATCCACTTGATGT -> CTATTATCCACTTGATGTT
ACTATTCGTCATGAGCACA -> CTATTCGTCATGAGCACAC
ACTATTCTCACGGTCTCCA -> CTATTCTCACGGTCTCCAT
ACTATTTAACCGGGATCGT -> CTATTTAACCGGGATCGTT
ACTCCAGTGTCTGCATATG -> CTCCAGTGTCTGCATATGT
ACTCGACTGCGGCGTGAAC -> CTCGACTGCGGCGTGAACA
ACTCTGTGTGATGCATAGC -> CTCTGTGTGATGCATAGCA
ACTGACAGAGAATCGCCGA -> CTGACAGAGAATCGCCGAG
ACTGATGATGATCGCTAGA -> CTGATGATGATCGCTAGAG
ACTGCCAGACACCCTCAGG -> CTGCCAGACACCCTCAGGT
ACTGCGGCGTGAACATGCG -> CTGCGGCGTGAACATGCGT
ACTGGTACACTGTGCCACT -> CTGGTACACTGTGCCACTA
ACTGTAAGCATTCGAGGAT -> CTGTAAGCATTCGAGGATT
ACTGTGCCACTATTATCCA -> CTGTGCCACTATTATCCAC
ACTGTGGATTTAAGCTTTG -> CTGTGGATTTAAGCTTTGA
ACTTATACGATCCCAATCA -> CTTATACGATCCCAATCAT
ACTTATACGATCCCACACC -> CTTATACGATCCCACACCT
ACTTATACGATCCCAGTTG -> CTTATACGATCCCAGTTGT
ACTTATACGATCCCATTGG -> CTTATACGATCCCATTGGC
ACTTCTCGGTTGTGGATCA -> CTTCTCGGTTGTGGATCAT
ACTTGAAGTCTCATTTGCG -> CTTGAAGTCTCATTTGCGT
ACTTGATGTTTCGCCCTGA -> CTTGATGTTTCGCCCTGAG
ACTTGCCGTCCGAAATATC -> CTTGCCGTCCGAAATATCG
ACTTGGAGCAGTGATATCT -> CTTGGAGCAGTGATATCTT
ACTTGGTCGGGCAGGCCGG -> CTTGGTCGGGCAGGCCGGG
ACTTGTTCTACATTGAACG -> CTTGTTCTACATTGAACGG
ACTTTCACCTTATTTAATG -> CTTTCACCTTATTTAATGA
ACTTTCTGCCAGCTTCCAC -> CTTTCTGCCAGCTTCCACA
ACTTTGATGGTGTGTCGGG -> CTTTGATGGTGTGTCGGGT
ACTTTTTAAGCCATTTCCT -> CTTTTTAAGCCATTTCCTC
AGAAAACCCCGGAGCTTTC -> GAAAACCCCGGAGCTTTCG
AGAAATAAATGCAGAGTAG -> GAAATAAATGCAGAGTAGC
AGAATCGCCGAGACTTTTT -> GAATCGCCGAGACTTTTTA
AGACACCCGACATCCACGC -> GACACCCGACATCCACGCA
AGACACCCTCAGGTTAAAT -> GACACCCTCAGGTTAAATG
AGACAGACCAATGGGAGCA -> GACAGACCAATGGGAGCAC
AGACCAATGGAGGGTTAAA -> GACCAATGGAGGGTTAAAC
AGACCAATGGGAGCACGGT -> GACCAATGGGAGCACGGTC
AGACGCAGTTTCACGGCTT -> GACGCAGTTTCACGGCTTT
AGACGCCCTACGATCGGTT -> GACGCCCTACGATCGGTTT
AGACTTTGATGGTGTGTCG -> GACTTTGATGGTGTGTCGG
AGACTTTTTAAGCCATTTC -> GACTTTTTAAGCCATTTCC
AGAGAATCGCCGAGACTTT -> GAGAATCGCCGAGACTTTT
AGAGAGCCGAACTTATACG -> GAGAGCCGAACTTATACGA
AGAGAGCCTCTAAGGGAAT -> GAGAGCCTCTAAGGGAATA
AGAGAGGCTGCCCTGTATA -> GAGAGGCTGCCCTGTATAG
AGAGATCAGTTTGTCACCC -> GAGATCAGTTTGTCACCCG
AGAGCCGAACTTATACGAT -> GAGCCGAACTTATACGATC
AGAGCCTCTAAGGGAATAT -> GAGCCTCTAAGGGAATATC
AGAGGCCTGCGGCTAAAGA -> GAGGCCTGCGGCTAAAGAT
AGAGGCTGCCCTGTATAGG -> GAGGCTGCCCTGTATAGGC
AGAGGGAGGATCTACACGC -> GAGGGAGGATCTACACGCG
AGAGTAGCGTCTGTCCTGT -> GAGTAGCGTCTGTCCTGTG
AGAGTCCAAGGGCCCATTG -> GAGTCCAAGGGCCCATTGG
AGATAACAGAGTCCAAGGG -> GATAACAGAGTCCAAGGGC
AGATATTTGTGATGCCAGG -> GATATTTGTGATGCCAGGT
AGATCAGTTTGTCACCCGA -> GATCAGTTTGTCACCCGAA
AGATCGATGCAAGCTACAC -> GATCGATGCAAGCTACACT
AGCAACGAGCTGTCGAGGG -> GCAACGAGCTGTCGAGGGA
AGCAAGAAATAAATGCAGA -> GCAAGAAATAAATGCAGAG
AGCACACTGCCAGACACCC -> GCACACTGCCAGACACCCT
AGCACGGTCCGCGGAGTAA -> GCACGGTCCGCGGAGTAAG
AGCACTGGTACACTGTGCC -> GCACTGGTACACTGTGCCA
AGCAGAGGGAGGATCTACA -> GCAGAGGGAGGATCTACAC
AGCAGTACGACGAGCTAAC -> GCAGTACGACGAGCTAACT
AGCAGTGATATCTTAACGG -> GCAGTGATATCTTAACGGC
AGCATTCGAGGATTCCCCC -> GCATTCGAGGATTCCCCCA
AGCCATTTCCTCTCGTCGT -> GCCATTTCCTCTCGTCGTT
AGCCCGTCGTAAAAAATCA -> GCCCGTCGTAAAAAATCAA
AGCCGAACTTATACGATCC -> GCCGAACTTATACGATCCC
AGCCTCTAAGGGAATATCG -> GCCTCTAAGGGAATATCGG
AGCCTGTCCTAAAGGGTGA -> GCCTGTCCTAAAGGGTGAA
AGCCTTACTGACAGAGAAT -> GCCTTACTGACAGAGAATC
AGCGCTAGTCATGCGGTAT -> GCGCTAGTCATGCGGTATG
AGCGTCTGTCCTGTGGTCT -> GCGTCTGTCCTGTGGTCTT
AGCGTGCTGACAGTGGGGT -> GCGTGCTGACAGTGGGGTG
AGCTAACTAGCCTGTCCTA -> GCTAACTAGCCTGTCCTAA
AGCTACACTTGGAGCAGTG -> GCTACACTTGGAGCAGTGA
AGCTAGTCTCACTTGGTCG -> GCTAGTCTCACTTGGTCGG
AGCTATGTGAGATAACAGA -> GCTATGTGAGATAACAGAG
AGCTATTCAAGAGAGGCTG -> GCTATTCAAGAGAGGCTGC
AGCTCCACCCAGCTAGTCT -> GCTCCACCCAGCTAGTCTC
AGCTGATCGCAAAGAGAGC -> GCTGATCGCAAAGAGAGCC
AGCTGCACGCCGTGACTAT -> GCTGCACGCCGTGACTATT
AGCTGCAGGCACAGAAAAC -> GCTGCAGGCACAGAAAACC
AGCTGTCGAGGGAGTACGC -> GCTGTCGAGGGAGTACGCG
AGCTTCCACAGGCGCACGG -> GCTTCCACAGGCGCACGGA
AGCTTTCGGATATCCACAA -> GCTTTCGGATATCCACAAC
AGCTTTGACCCCGTATCCC -> GCTTTGACCCCGTATCCCC
AGGAACGCCAAGGCCTACG -> GGAACGCCAAGGCCTACGA
AGGAATCGCAGACGCCCTA -> GGAATCGCAGACGCCCTAC
AGGACACCCACAGTTACCC -> GGACACCCACAGTTACCCC
AGGACATGGAATCTTGGCC -> GGACATGGAATCTTGGCCC
AGGACCATCATCAGGATTG -> GGACCATCATCAGGATTGC
AGGACTATTCGTCATGAGC -> GGACTATTCGTCATGAGCA
AGGAGCTATGTGAGATAAC -> GGAGCTATGTGAGATAACA
AGGATCGAATCTGGAACTC -> GGATCGAATCTGGAACTCA
AGGATCTACACGCGTGCGA -> GGATCTACACGCGTGCGAG
AGGATGGCTTATGCTCCCG -> GGATGGCTTATGCTCCCGG
AGGATTCCCCCAGCAGTAC -> GGATTCCCCCAGCAGTACG
AGGATTGCGTTCGATAATG -> GGATTGCGTTCGATAATGA
AGGCACAGAAAACCCCGGA -> GGCACAGAAAACCCCGGAG
AGGCATGTTATACCTACGG -> GGCATGTTATACCTACGGG
AGGCATTCCATTGAACATG -> GGCATTCCATTGAACATGC
AGGCCCCGTCCTGTGACGG -> GGCCCCGTCCTGTGACGGC
AGGCCGGGCAAACCATCGT -> GGCCGGGCAAACCATCGTT
AGGCCTACGAAATTCTTTA -> GGCCTACGAAATTCTTTAA
AGGCCTGCGGCTAAAGATC -> GGCCTGCGGCTAAAGATCG
AGGCGCACGGATACTCGAC -> GGCGCACGGATACTCGACT
AGGCTGCCCTGTATAGGCA -> GGCTGCCCTGTATAGGCAT
AGGGAATATCGGGTCAAAA -> GGGAATATCGGGTCAAAAC
AGGGACAGGTCAGTCAGTG -> GGGACAGGTCAGTCAGTGG
AGGGACTAAGAGATCAGTT -> GGGACTAAGAGATCAGTTT
AGGGAGGAATCGCAGACGC -> GGGAGGAATCGCAGACGCC
AGGGAGGATCTACACGCGT -> GGGAGGATCTACACGCGTG
AGGGAGTACGCGCGTACAA -> GGGAGTACGCGCGTACAAC
AGGGCCCATTGGTACGGTG -> GGGCCCATTGGTACGGTGA
AGGGGGATGGTGCTGGTCA -> GGGGGATGGTGCTGGTCAC
AGGGTGAATCCCATAAAAG -> GGGTGAATCCCATAAAAGA
AGGGTTAAACTATTTAACC -> GGGTTAAACTATTTAACCG
AGGTCAACCGGGTGACCCT -> GGTCAACCGGGTGACCCTT
AGGTCAAGGTCAACCGGGT -> GGTCAAGGTCAACCGGGTG
AGGTCAGTCAGTGGAAGCC -> GGTCAGTCAGTGGAAGCCT
AGGTCCGTAATTGCTCCAG -> GGTCCGTAATTGCTCCAGG
AGGTGCCTATCAGCAGAGG -> GGTGCCTATCAGCAGAGGG
AGGTGTCAGTCCTAGTACG -> GGTGTCAGTCCTAGTACGT
AGGTTAAATGTCGCTTCTT -> GGTTAAATGTCGCTTCTTG
AGTAACTCTGTGTGATGCA -> GTAACTCTGTGTGATGCAT
AGTAAGCGTGCTGACAGTG -> GTAAGCGTGCTGACAGTGG
AGTACGACGAGCTAACTAG -> GTACGACGAGCTAACTAGC
AGTACGCGCGTACAACTTG -> GTACGCGCGTACAACTTGT
AGTACGTGTAGTGTACGAT -> GTACGTGTAGTGTACGATT
AGTAGACACCCGACATCCA -> GTAGACACCCGACATCCAC
AGTAGCGTCTGTCCTGTGG -> GTAGCGTCTGTCCTGTGGT
AGTATCTGATAATCGTGGG -> GTATCTGATAATCGTGGGA
AGTATCTTACTTTCACCTT -> GTATCTTACTTTCACCTTA
AGTATTGAATGAAAGGCCC -> GTATTGAATGAAAGGCCCC
AGTCAGTGGAAGCCTTACT -> GTCAGTGGAAGCCTTACTG
AGTCATGCGGTATGGAGCT -> GTCATGCGGTATGGAGCTG
AGTCCAAGGGCCCATTGGT -> GTCCAAGGGCCCATTGGTA
AGTCCAATCGTCACTTCTC -> GTCCAATCGTCACTTCTCG
AGTCCTAGTACGTGTAGTG -> GTCCTAGTACGTGTAGTGT
AGTCTCACTTGGTCGGGCA -> GTCTCACTTGGTCGGGCAG
AGTCTCATTTGCGTACGGG -> GTCTCATTTGCGTACGGGC
AGTGATATCTTAACGGCGC -> GTGATATCTTAACGGCGCC
AGTGGAAGCCTTACTGACA -> GTGGAAGCCTTACTGACAG
AGTGGACGCTTTATTGTAG -> GTGGACGCTTTATTGTAGT
AGTGGATGTCCTACCGGTC -> GTGGATGTCCTACCGGTCT
AGTGGCTGGCTAAATCTTG -> GTGGCTGGCTAAATCTTGG,GTGGCTGGCTAAATCTTGG,GTGGCTGGCTAAATCTTGT,GTGGCTGGCTAAATCTTGT
AGTGGGGTGAAGGACCATC -> GTGGGGTGAAGGACCATCA
AGTGTACGATTGCGAACTT -> GTGTACGATTGCGAACTTA
AGTGTCTGCATATGTTAAA -> GTGTCTGCATATGTTAAAC
AGTTACCCCTAGGGACAGG -> GTTACCCCTAGGGACAGGT
AGTTGTGATTTAAGTGGCT -> GTTGTGATTTAAGTGGCTG
AGTTTAATTTTAAGGACAT -> GTTTAATTTTAAGGACATG
AGTTTCACGGCTTTTGTAG -> GTTTCACGGCTTTTGTAGC
AGTTTGTCACCCGAAGTAA -> GTTTGTCACCCGAAGTAAC
ATAAAAGACTTTGATGGTG -> TAAAAGACTTTGATGGTGT
ATAAATGCAGAGTAGCGTC -> TAAATGCAGAGTAGCGTCT
ATAACAGAGTCCAAGGGCC -> TAACAGAGTCCAAGGGCCC
ATAATATCAGTGGCTGGCT -> TAATATCAGTGGCTGGCTA
ATAATCGTGGGAATGTTGT -> TAATCGTGGGAATGTTGTG
ATAATGAGCAACGAGCTGT -> TAATGAGCAACGAGCTGTC
ATACAATAGGGAGGAATCG -> TACAATAGGGAGGAATCGC
ATACCGAGGGACTAAGAGA -> TACCGAGGGACTAAGAGAT
ATACCTACGGGGAACCCTG -> TACCTACGGGGAACCCTGC
ATACGATCCCAATCATAAT -> TACGATCCCAATCATAATA
ATACGATCCCACACCTGCG -> TACGATCCCACACCTGCGG
ATACGATCCCAGTTGTGAT -> TACGATCCCAGTTGTGATT
ATACGATCCCATTGGCAAC -> TACGATCCCATTGGCAACC
ATACTCGACTGCGGCGTGA -> TACTCGACTGCGGCGTGAA
ATAGCACTGGTACACTGTG -> TAGCACTGGTACACTGTGC
ATAGGACTATTCGTCATGA -> TAGGACTATTCGTCATGAG
ATAGGAGCTATGTGAGATA -> TAGGAGCTATGTGAGATAA
ATAGGCATGTTATACCTAC -> TAGGCATGTTATACCTACG
ATAGGGAGGAATCGCAGAC -> TAGGGAGGAATCGCAGACG
ATAGTCCAATCGTCACTTC -> TAGTCCAATCGTCACTTCT
ATATCAGATATTTGTGATG -> TATCAGATATTTGTGATGC
ATATCAGTGGCTGGCTAAA -> TATCAGTGGCTGGCTAAAT
ATATCCACAACAGCTGCAC -> TATCCACAACAGCTGCACG
ATATCGATATGTACACATG -> TATCGATATGTACACATGG
ATATCGGGTCAAAACTAGT -> TATCGGGTCAAAACTAGTA
ATATCTTAACGGCGCCTAC -> TATCTTAACGGCGCCTACT
ATATGCGTAGTATTGAATG -> TATGCGTAGTATTGAATGA
ATATGTACACATGGAACTA -> TATGTACACATGGAACTAC
ATATGTACGTTATTGCCGT -> TATGTACGTTATTGCCGTG
ATATGTTAAACACTGTAAG -> TATGTTAAACACTGTAAGC
ATATTTGTGATGCCAGGTG -> TATTTGTGATGCCAGGTGC
ATCAAGACGCAGTTTCACG -> TCAAGACGCAGTTTCACGG
ATCACTTTCTGCCAGCTTC -> TCACTTTCTGCCAGCTTCC
ATCAGATATTTGTGATGCC -> TCAGATATTTGTGATGCCA
ATCAGCAGAGGGAGGATCT -> TCAGCAGAGGGAGGATCTA
ATCAGGATTGCGTTCGATA -> TCAGGATTGCGTTCGATAA
ATCAGTGGCTGGCTAAATC -> TCAGTGGCTGGCTAAATCT
ATCAGTTTGTCACCCGAAG -> TCAGTTTGTCACCCGAAGT
ATCATAATATCAGTGGCTG -> TCATAATATCAGTGGCTGG
ATCATCAGGATTGCGTTCG -> TCATCAGGATTGCGTTCGA
ATCATCATGCTTCCCATAC -> TCATCATGCTTCCCATACC
ATCATCCAGCCCGTCGTAA -> TCATCCAGCCCGTCGTAAA
ATCATGCTTCCCATACCGA -> TCATGCTTCCCATACCGAG
ATCCACAACAGCTGCACGC -> TCCACAACAGCTGCACGCC
ATCCACGCACAAGAGGCCT -> TCCACGCACAAGAGGCCTG
ATCCACTTGATGTTTCGCC -> TCCACTTGATGTTTCGCCC
ATCCAGCCCGTCGTAAAAA -> TCCAGCCCGTCGTAAAAAA
ATCCCAATCATAATATCAG -> TCCCAATCATAATATCAGT
ATCCCACACCTGCGGTCAG -> TCCCACACCTGCGGTCAGT
ATCCCAGTTGTGATTTAAG -> TCCCAGTTGTGATTTAAGT
ATCCCATAAAAGACTTTGA -> TCCCATAAAAGACTTTGAT
ATCCCATTGGCAACCACAG -> TCCCATTGGCAACCACAGT
ATCCCCACGGGAGGTGTCA -> TCCCCACGGGAGGTGTCAG
ATCCCCGGAATGATATGCG -> TCCCCGGAATGATATGCGT
ATCCCCTGCTGCTCGCAGT -> TCCCCTGCTGCTCGCAGTA
ATCCTAATCCCCACGGGAG -> TCCTAATCCCCACGGGAGG
ATCGAATCTGGAACTCAGG -> TCGAATCTGGAACTCAGGG
ATCGATATGTACACATGGA -> TCGATATGTACACATGGAA
ATCGATGCAAGCTACACTT -> TCGATGCAAGCTACACTTG
ATCGCAAAGAGAGCCTCTA -> TCGCAAAGAGAGCCTCTAA
ATCGCAGACGCCCTACGAT -> TCGCAGACGCCCTACGATC
ATCGCCCTTACTTGAAGTC -> TCGCCCTTACTTGAAGTCT
ATCGCCGAGACTTTTTAAG -> TCGCCGAGACTTTTTAAGC
ATCGCTAGAGAGCCGAACT -> TCGCTAGAGAGCCGAACTT
ATCGGGTCAAAACTAGTAT -> TCGGGTCAAAACTAGTATC
ATCGGTGCGATATCAGATA -> TCGGTGCGATATCAGATAT
ATCGGTTTTGCCCCAGGTC -> TCGGTTTTGCCCCAGGTCC
ATCGTCACTTCTCGGTTGT -> TCGTCACTTCTCGGTTGTG
ATCGTGGGAATGTTGTGGT -> TCGTGGGAATGTTGTGGTT
ATCGTTACACTGATGATGA -> TCGTTACACTGATGATGAT
ATCGTTTAGGGGGATGGTG -> TCGTTTAGGGGGATGGTGC
ATCTACACGCGTGCGAGGA -> TCTACACGCGTGCGAGGAT
ATCTCCTAGCGCTAGTCAT -> TCTCCTAGCGCTAGTCATG
ATCTGATAATCGTGGGAAT -> TCTGATAATCGTGGGAATG
ATCTGGAACTCAGGGGGGA -> TCTGGAACTCAGGGGGGAA
ATCTTAACGGCGCCTACTT -> TCTTAACGGCGCCTACTTG
ATCTTACTTTCACCTTATT -> TCTTACTTTCACCTTATTT
ATCTTGGATACAATAGGGA -> TCTTGGATACAATAGGGAG
ATCTTGGCCAATCGCCCTT -> TCTTGGCCAATCGCCCTTA
ATCTTGGCCCTATCGGTGC -> TCTTGGCCCTATCGGTGCG
ATCTTGTCCGCAAGCTGAT -> TCTTGTCCGCAAGCTGATC
ATCTTGTTGGTTCCTGTCT -> TCTTGTTGGTTCCTGTCTC
ATGAAAGGCCCCGTCCTGT -> TGAAAGGCCCCGTCCTGTG
ATGAACTGTGGATTTAAGC -> TGAACTGTGGATTTAAGCT
ATGACATGTTGAGTATCTG -> TGACATGTTGAGTATCTGA
ATGAGCAACGAGCTGTCGA -> TGAGCAACGAGCTGTCGAG
ATGAGCACACTGCCAGACA -> TGAGCACACTGCCAGACAC
ATGAGTTTAATTTTAAGGA -> TGAGTTTAATTTTAAGGAC
ATGATATGCGTAGTATTGA -> TGATATGCGTAGTATTGAA
ATGATCGCTAGAGAGCCGA -> TGATCGCTAGAGAGCCGAA
ATGATGATCGCTAGAGAGC -> TGATGATCGCTAGAGAGCC
ATGCAAGCTACACTTGGAG -> TGCAAGCTACACTTGGAGC
ATGCAGAGTAGCGTCTGTC -> TGCAGAGTAGCGTCTGTCC
ATGCATAGCACTGGTACAC -> TGCATAGCACTGGTACACT
ATGCCAATCTCCTAGCGCT -> TGCCAATCTCCTAGCGCTA
ATGCCAGGTGCCTATCAGC -> TGCCAGGTGCCTATCAGCA
ATGCGGTATGGAGCTGCAG -> TGCGGTATGGAGCTGCAGG
ATGCGTAGTATTGAATGAA -> TGCGTAGTATTGAATGAAA
ATGCGTCTATAGTCCAATC -> TGCGTCTATAGTCCAATCG
ATGCTCCAGGATCGAATCT -> TGCTCCAGGATCGAATCTG
ATGCTCCCGGACCTCTCGC -> TGCTCCCGGACCTCTCGCT
ATGCTTCCCATACCGAGGG -> TGCTTCCCATACCGAGGGA
ATGCTTTGCAGACAGACCA -> TGCTTTGCAGACAGACCAA
ATGGAACTACGAACGTGCT -> TGGAACTACGAACGTGCTC
ATGGAATCTTGGCCCTATC -> TGGAATCTTGGCCCTATCG
ATGGAGCTGCAGGCACAGA -> TGGAGCTGCAGGCACAGAA
ATGGAGGGTTAAACTATTT -> TGGAGGGTTAAACTATTTA
ATGGCTTATGCTCCCGGAC -> TGGCTTATGCTCCCGGACC
ATGGGAGCACGGTCCGCGG -> TGGGAGCACGGTCCGCGGA
ATGGTGCTGGTCACAAAAA -> TGGTGCTGGTCACAAAAAT
ATGGTGTGTCGGGTGATGC -> TGGTGTGTCGGGTGATGCT
ATGTACACATGGAACTACG -> TGTACACATGGAACTACGA
ATGTACGTTATTGCCGTGT -> TGTACGTTATTGCCGTGTC
ATGTCCTACCGGTCTCTGT -> TGTCCTACCGGTCTCTGTG
ATGTCCTCGAACTTATACG -> TGTCCTCGAACTTATACGA
ATGTCGCTTCTTGCCACTC -> TGTCGCTTCTTGCCACTCC
ATGTGAGATAACAGAGTCC -> TGTGAGATAACAGAGTCCA
ATGTTAAACACTGTAAGCA -> TGTTAAACACTGTAAGCAT
ATGTTATACCTACGGGGAA -> TGTTATACCTACGGGGAAC
ATGTTGAGTATCTGATAAT -> TGTTGAGTATCTGATAATC
ATGTTGTGGTTCCCTCTTA -> TGTTGTGGTTCCCTCTTAT
ATGTTTCGCCCTGAGCTAT -> TGTTTCGCCCTGAGCTATT
ATTACGCGTTGCATCACTT -> TTACGCGTTGCATCACTTT
ATTAGTGGACGCTTTATTG -> TTAGTGGACGCTTTATTGT
ATTATCCACTTGATGTTTC -> TTATCCACTTGATGTTTCG
ATTCAAGAGAGGCTGCCCT -> TTCAAGAGAGGCTGCCCTG
ATTCCATTGAACATGCCAA -> TTCCATTGAACATGCCAAT
ATTCCCCCAGCAGTACGAC -> TTCCCCCAGCAGTACGACG
ATTCGAGGATTCCCCCAGC -> TTCGAGGATTCCCCCAGCA
ATTCGTCATGAGCACACTG -> TTCGTCATGAGCACACTGC
ATTCTCACGGTCTCCATTT -> TTCTCACGGTCTCCATTTC
ATTCTTTAATGTCCTCGAA -> TTCTTTAATGTCCTCGAAC
ATTGAACATGCCAATCTCC -> TTGAACATGCCAATCTCCT
ATTGAACGGGACGAACTTA -> TTGAACGGGACGAACTTAT
ATTGAATGAAAGGCCCCGT -> TTGAATGAAAGGCCCCGTC
ATTGCCGTGTCGCCGGACG -> TTGCCGTGTCGCCGGACGT
ATTGCGAACTTATACGATC -> TTGCGAACTTATACGATCC
ATTGCGTTCGATAATGAGC -> TTGCGTTCGATAATGAGCA
ATTGCTCCAGGCATTCCAT -> TTGCTCCAGGCATTCCATT
ATTGGCAACCACAGTGGCT -> TTGGCAACCACAGTGGCTG
ATTGGTACGGTGACTATTC -> TTGGTACGGTGACTATTCT
ATTGTAGTGGATGTCCTAC -> TTGTAGTGGATGTCCTACC
ATTTAACCGGGATCGTTAC -> TTTAACCGGGATCGTTACA
ATTTAAGCTTTGACCCCGT -> TTTAAGCTTTGACCCCGTA
ATTTAAGTGGCTGGCTAAA -> TTTAAGTGGCTGGCTAAAT
ATTTAATGAGTTTAATTTT -> TTTAATGAGTTTAATTTTA
ATTTCCTCTCGTCGTTAAC -> TTTCCTCTCGTCGTTAACG
ATTTCGGTGATGCTCCAGG -> TTTCGGTGATGCTCCAGGA
ATTTGCGTACGGGCAAGGT -> TTTGCGTACGGGCAAGGTC
ATTTGTGATGCCAGGTGCC -> TTTGTGATGCCAGGTGCCT
ATTTTAAGGACATGGAATC -> TTTTAAGGACATGGAATCT
CAAAAATAGGAGCTATGTG -> AAAAATAGGAGCTATGTGA
CAAAACTAGTATCTTACTT -> AAAACTAGTATCTTACTTT
CAAACCATCGTTTAGGGGG -> AAACCATCGTTTAGGGGGA
CAAAGAGAGCCTCTAAGGG -> AAAGAGAGCCTCTAAGGGA
CAACAGCTGCACGCCGTGA -> AACAGCTGCACGCCGTGAC
CAACCACAGTGGCTGGCTA -> AACCACAGTGGCTGGCTAA
CAACCGGGTGACCCTTAAA -> AACCGGGTGACCCTTAAAT
CAACGAGCTGTCGAGGGAG -> AACGAGCTGTCGAGGGAGT
CAACTTGTTCTACATTGAA -> AACTTGTTCTACATTGAAC
CAAGAAATAAATGCAGAGT -> AAGAAATAAATGCAGAGTA
CAAGACCAATGGAGGGTTA -> AAGACCAATGGAGGGTTAA
CAAGACGCAGTTTCACGGC -> AAGACGCAGTTTCACGGCT
CAAGAGAGGCTGCCCTGTA -> AAGAGAGGCTGCCCTGTAT
CAAGAGGCCTGCGGCTAAA -> AAGAGGCCTGCGGCTAAAG
CAAGCTACACTTGGAGCAG -> AAGCTACACTTGGAGCAGT
CAAGCTGATCGCAAAGAGA -> AAGCTGATCGCAAAGAGAG
CAAGGCCTACGAAATTCTT -> AAGGCCTACGAAATTCTTT
CAAGGGCCCATTGGTACGG -> AAGGGCCCATTGGTACGGT
CAAGGTCAACCGGGTGACC -> AAGGTCAACCGGGTGACCC
CAAGGTCAAGGTCAACCGG -> AAGGTCAAGGTCAACCGGG
CAATAGGGAGGAATCGCAG -> AATAGGGAGGAATCGCAGA
CAATCATAATATCAGTGGC -> AATCATAATATCAGTGGCT
CAATCCTAATCCCCACGGG -> AATCCTAATCCCCACGGGA
CAATCGCCCTTACTTGAAG -> AATCGCCCTTACTTGAAGT
CAATCGTCACTTCTCGGTT -> AATCGTCACTTCTCGGTTG
CAATCTCCTAGCGCTAGTC -> AATCTCCTAGCGCTAGTCA
CAATGGAGGGTTAAACTAT -> AATGGAGGGTTAAACTATT
CAATGGGAGCACGGTCCGC -> AATGGGAGCACGGTCCGCG
CACAAAAATAGGAGCTATG -> ACAAAAATAGGAGCTATGT
CACAACAGCTGCACGCCGT -> ACAACAGCTGCACGCCGTG
CACAAGACCAATGGAGGGT -> ACAAGACCAATGGAGGGTT
CACAAGAGGCCTGCGGCTA -> ACAAGAGGCCTGCGGCTAA
CACACCTGCGGTCAGTGGC -> ACACCTGCGGTCAGTGGCT
CACACTGCCAGACACCCTC -> ACACTGCCAGACACCCTCA
CACAGAAAACCCCGGAGCT -> ACAGAAAACCCCGGAGCTT
CACAGGCGCACGGATACTC -> ACAGGCGCACGGATACTCG
CACAGTGGCTGGCTAAATC -> ACAGTGGCTGGCTAAATCT
CACAGTTACCCCTAGGGAC -> ACAGTTACCCCTAGGGACA
CACATGGAACTACGAACGT -> ACATGGAACTACGAACGTG
CACCCACAGTTACCCCTAG -> ACCCACAGTTACCCCTAGG
CACCCAGCTAGTCTCACTT -> ACCCAGCTAGTCTCACTTG
CACCCCCCGAATAGGACTA -> ACCCCCCGAATAGGACTAT
CACCCGAAGTAACTCTGTG -> ACCCGAAGTAACTCTGTGT
CACCCGACATCCACGCACA -> ACCCGACATCCACGCACAA
CACCCTCAGGTTAAATGTC -> ACCCTCAGGTTAAATGTCG
CACCTGCGGTCAGTGGCTG -> ACCTGCGGTCAGTGGCTGG
CACCTTATTTAATGAGTTT -> ACCTTATTTAATGAGTTTA
CACGCACAAGAGGCCTGCG -> ACGCACAAGAGGCCTGCGG
CACGCCGTGACTATTAGTG -> ACGCCGTGACTATTAGTGG
CACGCGTGCGAGGATGGCT -> ACGCGTGCGAGGATGGCTT
CACGGATACTCGACTGCGG -> ACGGATACTCGACTGCGGC
CACGGCTTTTGTAGCAAGA -> ACGGCTTTTGTAGCAAGAA
CACGGGAGGTGTCAGTCCT -> ACGGGAGGTGTCAGTCCTA
CACGGTCCGCGGAGTAAGC -> ACGGTCCGCGGAGTAAGCG
CACGGTCTCCATTTCGGTG -> ACGGTCTCCATTTCGGTGA
CACTATCATCCAGCCCGTC -> ACTATCATCCAGCCCGTCG
CACTATGAACTGTGGATTT -> ACTATGAACTGTGGATTTA
CACTATTATCCACTTGATG -> ACTATTATCCACTTGATGT
CACTCCAGTGTCTGCATAT -> ACTCCAGTGTCTGCATATG
CACTGATGATGATCGCTAG -> ACTGATGATGATCGCTAGA
CACTGCCAGACACCCTCAG -> ACTGCCAGACACCCTCAGG
CACTGGTACACTGTGCCAC -> ACTGGTACACTGTGCCACT
CACTGTAAGCATTCGAGGA -> ACTGTAAGCATTCGAGGAT
CACTGTGCCACTATTATCC -> ACTGTGCCACTATTATCCA
CACTTCTCGGTTGTGGATC -> ACTTCTCGGTTGTGGATCA
CACTTGATGTTTCGCCCTG -> ACTTGATGTTTCGCCCTGA
CACTTGGAGCAGTGATATC -> ACTTGGAGCAGTGATATCT
CACTTGGTCGGGCAGGCCG -> ACTTGGTCGGGCAGGCCGG
CACTTTCTGCCAGCTTCCA -> ACTTTCTGCCAGCTTCCAC
CAGAAAACCCCGGAGCTTT -> AGAAAACCCCGGAGCTTTC
CAGACACCCTCAGGTTAAA -> AGACACCCTCAGGTTAAAT
CAGACAGACCAATGGGAGC -> AGACAGACCAATGGGAGCA
CAGACCAATGGGAGCACGG -> AGACCAATGGGAGCACGGT
CAGACGCCCTACGATCGGT -> AGACGCCCTACGATCGGTT
CAGAGAATCGCCGAGACTT -> AGAGAATCGCCGAGACTTT
CAGAGGGAGGATCTACACG -> AGAGGGAGGATCTACACGC
CAGAGTAGCGTCTGTCCTG -> AGAGTAGCGTCTGTCCTGT
CAGAGTCCAAGGGCCCATT -> AGAGTCCAAGGGCCCATTG
CAGATATTTGTGATGCCAG -> AGATATTTGTGATGCCAGG
CAGCAGAGGGAGGATCTAC -> AGCAGAGGGAGGATCTACA
CAGCAGTACGACGAGCTAA -> AGCAGTACGACGAGCTAAC
CAGCCCGTCGTAAAAAATC -> AGCCCGTCGTAAAAAATCA
CAGCTAGTCTCACTTGGTC -> AGCTAGTCTCACTTGGTCG
CAGCTGCACGCCGTGACTA -> AGCTGCACGCCGTGACTAT
CAGCTTCCACAGGCGCACG -> AGCTTCCACAGGCGCACGG
CAGGAACGCCAAGGCCTAC -> AGGAACGCCAAGGCCTACG
CAGGACACCCACAGTTACC -> AGGACACCCACAGTTACCC
CAGGATCGAATCTGGAACT -> AGGATCGAATCTGGAACTC
CAGGATTGCGTTCGATAAT -> AGGATTGCGTTCGATAATG
CAGGCACAGAAAACCCCGG -> AGGCACAGAAAACCCCGGA
CAGGCATTCCATTGAACAT -> AGGCATTCCATTGAACATG
CAGGCCGGGCAAACCATCG -> AGGCCGGGCAAACCATCGT
CAGGCGCACGGATACTCGA -> AGGCGCACGGATACTCGAC
CAGGTCAGTCAGTGGAAGC -> AGGTCAGTCAGTGGAAGCC
CAGGTCCGTAATTGCTCCA -> AGGTCCGTAATTGCTCCAG
CAGGTGCCTATCAGCAGAG -> AGGTGCCTATCAGCAGAGG
CAGGTTAAATGTCGCTTCT -> AGGTTAAATGTCGCTTCTT
CAGTACGACGAGCTAACTA -> AGTACGACGAGCTAACTAG
CAGTAGACACCCGACATCC -> AGTAGACACCCGACATCCA
CAGTCAGTGGAAGCCTTAC -> AGTCAGTGGAAGCCTTACT
CAGTCCTAGTACGTGTAGT -> AGTCCTAGTACGTGTAGTG
CAGTGATATCTTAACGGCG -> AGTGATATCTTAACGGCGC
CAGTGGAAGCCTTACTGAC -> AGTGGAAGCCTTACTGACA
CAGTGGCTGGCTAAATCTT -> AGTGGCTGGCTAAATCTTG,AGTGGCTGGCTAAATCTTG,AGTGGCTGGCTAAATCTTG
CAGTGGGGTGAAGGACCAT -> AGTGGGGTGAAGGACCATC
CAGTGTCTGCATATGTTAA -> AGTGTCTGCATATGTTAAA
CAGTTACCCCTAGGGACAG -> AGTTACCCCTAGGGACAGG
CAGTTGTGATTTAAGTGGC -> AGTTGTGATTTAAGTGGCT
CAGTTTCACGGCTTTTGTA -> AGTTTCACGGCTTTTGTAG
CAGTTTGTCACCCGAAGTA -> AGTTTGTCACCCGAAGTAA
CATAAAAGACTTTGATGGT -> ATAAAAGACTTTGATGGTG
CATAATATCAGTGGCTGGC -> ATAATATCAGTGGCTGGCT
CATACCGAGGGACTAAGAG -> ATACCGAGGGACTAAGAGA
CATAGCACTGGTACACTGT -> ATAGCACTGGTACACTGTG
CATATGTTAAACACTGTAA -> ATATGTTAAACACTGTAAG
CATCACTTTCTGCCAGCTT -> ATCACTTTCTGCCAGCTTC
CATCAGGATTGCGTTCGAT -> ATCAGGATTGCGTTCGATA
CATCATCAGGATTGCGTTC -> ATCATCAGGATTGCGTTCG
CATCATGCTTCCCATACCG -> ATCATGCTTCCCATACCGA
CATCCACGCACAAGAGGCC -> ATCCACGCACAAGAGGCCT
CATCCAGCCCGTCGTAAAA -> ATCCAGCCCGTCGTAAAAA
CATCGTTTAGGGGGATGGT -> ATCGTTTAGGGGGATGGTG
CATGAGCACACTGCCAGAC -> ATGAGCACACTGCCAGACA
CATGCCAATCTCCTAGCGC -> ATGCCAATCTCCTAGCGCT
CATGCGGTATGGAGCTGCA -> ATGCGGTATGGAGCTGCAG
CATGCGTCTATAGTCCAAT -> ATGCGTCTATAGTCCAATC
CATGCTTCCCATACCGAGG -> ATGCTTCCCATACCGAGGG
CATGGAACTACGAACGTGC -> ATGGAACTACGAACGTGCT
CATGGAATCTTGGCCCTAT -> ATGGAATCTTGGCCCTATC
CATGTTATACCTACGGGGA -> ATGTTATACCTACGGGGAA
CATGTTGAGTATCTGATAA -> ATGTTGAGTATCTGATAAT
CATTCCATTGAACATGCCA -> ATTCCATTGAACATGCCAA
CATTCGAGGATTCCCCCAG -> ATTCGAGGATTCCCCCAGC
CATTGAACATGCCAATCTC -> ATTGAACATGCCAATCTCC
CATTGAACGGGACGAACTT -> ATTGAACGGGACGAACTTA
CATTGGCAACCACAGTGGC -> ATTGGCAACCACAGTGGCT
CATTGGTACGGTGACTATT -> ATTGGTACGGTGACTATTC
CATTTCCTCTCGTCGTTAA -> ATTTCCTCTCGTCGTTAAC
CATTTCGGTGATGCTCCAG -> ATTTCGGTGATGCTCCAGG
CATTTGCGTACGGGCAAGG -> ATTTGCGTACGGGCAAGGT
CCAAGGCCTACGAAATTCT -> CAAGGCCTACGAAATTCTT
CCAAGGGCCCATTGGTACG -> CAAGGGCCCATTGGTACGG
CCAATCATAATATCAGTGG -> CAATCATAATATCAGTGGC
CCAATCGCCCTTACTTGAA -> CAATCGCCCTTACTTGAAG
CCAATCGTCACTTCTCGGT -> CAATCGTCACTTCTCGGTT
CCAATCTCCTAGCGCTAGT -> CAATCTCCTAGCGCTAGTC
CCAATGGAGGGTTAAACTA -> CAATGGAGGGTTAAACTAT
CCAATGGGAGCACGGTCCG -> CAATGGGAGCACGGTCCGC
CCACAACAGCTGCACGCCG -> CACAACAGCTGCACGCCGT
CCACACCTGCGGTCAGTGG -> CACACCTGCGGTCAGTGGC
CCACAGGCGCACGGATACT -> CACAGGCGCACGGATACTC
CCACAGTGGCTGGCTAAAT -> CACAGTGGCTGGCTAAATC
CCACAGTTACCCCTAGGGA -> CACAGTTACCCCTAGGGAC
CCACCCAGCTAGTCTCACT -> CACCCAGCTAGTCTCACTT
CCACGCACAAGAGGCCTGC -> CACGCACAAGAGGCCTGCG
CCACGGGAGGTGTCAGTCC -> CACGGGAGGTGTCAGTCCT
CCACTATTATCCACTTGAT -> CACTATTATCCACTTGATG
CCACTCCAGTGTCTGCATA -> CACTCCAGTGTCTGCATAT
CCACTTGATGTTTCGCCCT -> CACTTGATGTTTCGCCCTG
CCAGACACCCTCAGGTTAA -> CAGACACCCTCAGGTTAAA
CCAGCAGTACGACGAGCTA -> CAGCAGTACGACGAGCTAA
CCAGCCCGTCGTAAAAAAT -> CAGCCCGTCGTAAAAAATC
CCAGCTAGTCTCACTTGGT -> CAGCTAGTCTCACTTGGTC
CCAGCTTCCACAGGCGCAC -> CAGCTTCCACAGGCGCACG
CCAGGATCGAATCTGGAAC -> CAGGATCGAATCTGGAACT
CCAGGCATTCCATTGAACA -> CAGGCATTCCATTGAACAT
CCAGGTCCGTAATTGCTCC -> CAGGTCCGTAATTGCTCCA
CCAGGTGCCTATCAGCAGA -> CAGGTGCCTATCAGCAGAG
CCAGTGTCTGCATATGTTA -> CAGTGTCTGCATATGTTAA
CCAGTTGTGATTTAAGTGG -> CAGTTGTGATTTAAGTGGC
CCATAAAAGACTTTGATGG -> CATAAAAGACTTTGATGGT
CCATACCGAGGGACTAAGA -> CATACCGAGGGACTAAGAG
CCATCATCAGGATTGCGTT -> CATCATCAGGATTGCGTTC
CCATCGTTTAGGGGGATGG -> CATCGTTTAGGGGGATGGT
CCATTGAACATGCCAATCT -> CATTGAACATGCCAATCTC
CCATTGGCAACCACAGTGG -> CATTGGCAACCACAGTGGC
CCATTGGTACGGTGACTAT -> CATTGGTACGGTGACTATT
CCATTTCCTCTCGTCGTTA -> CATTTCCTCTCGTCGTTAA
CCATTTCGGTGATGCTCCA -> CATTTCGGTGATGCTCCAG
CCCAATCATAATATCAGTG -> CCAATCATAATATCAGTGG
CCCACACCTGCGGTCAGTG -> CCACACCTGCGGTCAGTGG
CCCACAGTTACCCCTAGGG -> CCACAGTTACCCCTAGGGA
CCCACGGGAGGTGTCAGTC -> CCACGGGAGGTGTCAGTCC
CCCAGCAGTACGACGAGCT -> CCAGCAGTACGACGAGCTA
CCCAGCTAGTCTCACTTGG -> CCAGCTAGTCTCACTTGGT
CCCAGGTCCGTAATTGCTC -> CCAGGTCCGTAATTGCTCC
CCCAGTTGTGATTTAAGTG -> CCAGTTGTGATTTAAGTGG
CCCATAAAAGACTTTGATG -> CCATAAAAGACTTTGATGG
CCCATACCGAGGGACTAAG -> CCATACCGAGGGACTAAGA
CCCATTGGCAACCACAGTG -> CCATTGGCAACCACAGTGG
CCCATTGGTACGGTGACTA -> CCATTGGTACGGTGACTAT
CCCCACGGGAGGTGTCAGT -> CCCACGGGAGGTGTCAGTC
CCCCAGCAGTACGACGAGC -> CCCAGCAGTACGACGAGCT
CCCCAGGTCCGTAATTGCT -> CCCAGGTCCGTAATTGCTC
CCCCCAGCAGTACGACGAG -> CCCCAGCAGTACGACGAGC
CCCCCCGAATAGGACTATT -> CCCCCGAATAGGACTATTC
CCCCCGAATAGGACTATTC -> CCCCGAATAGGACTATTCG
CCCCGAATAGGACTATTCG -> CCCGAATAGGACTATTCGT
CCCCGGAATGATATGCGTA -> CCCGGAATGATATGCGTAG
CCCCGGAGCTTTCGGATAT -> CCCGGAGCTTTCGGATATC
CCCCGTATCCCCTGCTGCT -> CCCGTATCCCCTGCTGCTC
CCCCGTCACAAGACCAATG -> CCCGTCACAAGACCAATGG
CCCCGTCCTGTGACGGCAA -> CCCGTCCTGTGACGGCAAT
CCCCTAGGGACAGGTCAGT -> CCCTAGGGACAGGTCAGTC
CCCCTGCTGCTCGCAGTAG -> CCCTGCTGCTCGCAGTAGA
CCCGAAGTAACTCTGTGTG -> CCGAAGTAACTCTGTGTGA
CCCGAATAGGACTATTCGT -> CCGAATAGGACTATTCGTC
CCCGACATCCACGCACAAG -> CCGACATCCACGCACAAGA
CCCGGAATGATATGCGTAG -> CCGGAATGATATGCGTAGT
CCCGGACCTCTCGCTTCGA -> CCGGACCTCTCGCTTCGAT
CCCGGAGCTTTCGGATATC -> CCGGAGCTTTCGGATATCC
CCCGTATCCCCTGCTGCTC -> CCGTATCCCCTGCTGCTCG
CCCGTCACAAGACCAATGG -> CCGTCACAAGACCAATGGA
CCCGTCCTGTGACGGCAAT -> CCGTCCTGTGACGGCAATC
CCCGTCGTAAAAAATCAAG -> CCGTCGTAAAAAATCAAGA
CCCTACGATCGGTTTTGCC -> CCTACGATCGGTTTTGCCC
CCCTAGGGACAGGTCAGTC -> CCTAGGGACAGGTCAGTCA
CCCTATCGGTGCGATATCA -> CCTATCGGTGCGATATCAG
CCCTCAGGTTAAATGTCGC -> CCTCAGGTTAAATGTCGCT
CCCTCTTATCCCCGGAATG -> CCTCTTATCCCCGGAATGA
CCCTGAGCTATTCAAGAGA -> CCTGAGCTATTCAAGAGAG
CCCTGCACTATCATCCAGC -> CCTGCACTATCATCCAGCC
CCCTGCTGCTCGCAGTAGA -> CCTGCTGCTCGCAGTAGAC
CCCTGTATAGGCATGTTAT -> CCTGTATAGGCATGTTATA
CCCTTAAATATGTACGTTA -> CCTTAAATATGTACGTTAT
CCCTTACTTGAAGTCTCAT -> CCTTACTTGAAGTCTCATT
CCGAAATATCGATATGTAC -> CGAAATATCGATATGTACA
CCGAACTTATACGATCCCA -> CGAACTTATACGATCCCAC
CCGAAGTAACTCTGTGTGA -> CGAAGTAACTCTGTGTGAT
CCGAATAGGACTATTCGTC -> CGAATAGGACTATTCGTCA
CCGACATCCACGCACAAGA -> CGACATCCACGCACAAGAG
CCGAGACTTTTTAAGCCAT -> CGAGACTTTTTAAGCCATT
CCGAGGGACTAAGAGATCA -> CGAGGGACTAAGAGATCAG
CCGCAAGCTGATCGCAAAG -> CGCAAGCTGATCGCAAAGA
CCGCGGAGTAAGCGTGCTG -> CGCGGAGTAAGCGTGCTGA
CCGGAATGATATGCGTAGT -> CGGAATGATATGCGTAGTA
CCGGACCTCTCGCTTCGAT -> CGGACCTCTCGCTTCGATT
CCGGACGTCAGGACACCCA -> CGGACGTCAGGACACCCAC
CCGGAGCTTTCGGATATCC -> CGGAGCTTTCGGATATCCA
CCGGGATCGTTACACTGAT -> CGGGATCGTTACACTGATG
CCGGGCAAACCATCGTTTA -> CGGGCAAACCATCGTTTAG
CCGGGTGACCCTTAAATAT -> CGGGTGACCCTTAAATATG
CCGGTCTCTGTGGAGCTCC -> CGGTCTCTGTGGAGCTCCA
CCGTAATTGCTCCAGGCAT -> CGTAATTGCTCCAGGCATT
CCGTATCCCCTGCTGCTCG -> CGTATCCCCTGCTGCTCGC
CCGTCACAAGACCAATGGA -> CGTCACAAGACCAATGGAG
CCGTCCGAAATATCGATAT -> CGTCCGAAATATCGATATG
CCGTCCTGTGACGGCAATC -> CGTCCTGTGACGGCAATCC
CCGTCGTAAAAAATCAAGA -> CGTCGTAAAAAATCAAGAC
CCGTGACTATTAGTGGACG -> CGTGACTATTAGTGGACGC
CCGTGTCGCCGGACGTCAG -> CGTGTCGCCGGACGTCAGG
CCTAAAGGGTGAATCCCAT -> CTAAAGGGTGAATCCCATA
CCTAATCCCCACGGGAGGT -> CTAATCCCCACGGGAGGTG
CCTACCGGTCTCTGTGGAG -> CTACCGGTCTCTGTGGAGC
CCTACGAAATTCTTTAATG -> CTACGAAATTCTTTAATGT
CCTACGATCGGTTTTGCCC -> CTACGATCGGTTTTGCCCC
CCTACGGGGAACCCTGCAC -> CTACGGGGAACCCTGCACT
CCTACTTGCCGTCCGAAAT -> CTACTTGCCGTCCGAAATA
CCTAGCGCTAGTCATGCGG -> CTAGCGCTAGTCATGCGGT
CCTAGGGACAGGTCAGTCA -> CTAGGGACAGGTCAGTCAG
CCTAGTACGTGTAGTGTAC -> CTAGTACGTGTAGTGTACG
CCTATCAGCAGAGGGAGGA -> CTATCAGCAGAGGGAGGAT
CCTATCGGTGCGATATCAG -> CTATCGGTGCGATATCAGA
CCTCAGGTTAAATGTCGCT -> CTCAGGTTAAATGTCGCTT
CCTCGAACTTATACGATCC -> CTCGAACTTATACGATCCC
CCTCTAAGGGAATATCGGG -> CTCTAAGGGAATATCGGGT
CCTCTCGCTTCGATTACGC -> CTCTCGCTTCGATTACGCG
CCTCTCGTCGTTAACGGTG -> CTCTCGTCGTTAACGGTGC
CCTCTTATCCCCGGAATGA -> CTCTTATCCCCGGAATGAT
CCTGAGCTATTCAAGAGAG -> CTGAGCTATTCAAGAGAGG
CCTGCACTATCATCCAGCC -> CTGCACTATCATCCAGCCC
CCTGCGGCTAAAGATCGAT -> CTGCGGCTAAAGATCGATG
CCTGCGGTCAGTGGCTGGC -> CTGCGGTCAGTGGCTGGCT
CCTGCTGCTCGCAGTAGAC -> CTGCTGCTCGCAGTAGACA
CCTGTATAGGCATGTTATA -> CTGTATAGGCATGTTATAC
CCTGTCCTAAAGGGTGAAT -> CTGTCCTAAAGGGTGAATC
CCTGTCTCACTATGAACTG -> CTGTCTCACTATGAACTGT
CCTGTGACGGCAATCCTAA -> CTGTGACGGCAATCCTAAT
CCTGTGGTCTTCACCCCCC -> CTGTGGTCTTCACCCCCCG
CCTTAAATATGTACGTTAT -> CTTAAATATGTACGTTATT
CCTTACTGACAGAGAATCG -> CTTACTGACAGAGAATCGC
CCTTACTTGAAGTCTCATT -> CTTACTTGAAGTCTCATTT
CCTTATTTAATGAGTTTAA -> CTTATTTAATGAGTTTAAT
CGAAATATCGATATGTACA -> GAAATATCGATATGTACAC
CGAAATTCTTTAATGTCCT -> GAAATTCTTTAATGTCCTC
CGAACGTGCTCGGATGACA -> GAACGTGCTCGGATGACAT
CGAACTTATACGATCCCAA -> GAACTTATACGATCCCAAT
CGAACTTATACGATCCCAC -> GAACTTATACGATCCCACA
CGAACTTATACGATCCCAG -> GAACTTATACGATCCCAGT
CGAACTTATACGATCCCAT -> GAACTTATACGATCCCATT
CGAAGTAACTCTGTGTGAT -> GAAGTAACTCTGTGTGATG
CGAATAGGACTATTCGTCA -> GAATAGGACTATTCGTCAT
CGAATCTGGAACTCAGGGG -> GAATCTGGAACTCAGGGGG
CGACATCCACGCACAAGAG -> GACATCCACGCACAAGAGG
CGACGAGCTAACTAGCCTG -> GACGAGCTAACTAGCCTGT
CGACTGCGGCGTGAACATG -> GACTGCGGCGTGAACATGC
CGAGACTTTTTAAGCCATT -> GAGACTTTTTAAGCCATTT
CGAGCTAACTAGCCTGTCC -> GAGCTAACTAGCCTGTCCT
CGAGCTGTCGAGGGAGTAC -> GAGCTGTCGAGGGAGTACG
CGAGGATGGCTTATGCTCC -> GAGGATGGCTTATGCTCCC
CGAGGATTCCCCCAGCAGT -> GAGGATTCCCCCAGCAGTA
CGAGGGACTAAGAGATCAG -> GAGGGACTAAGAGATCAGT
CGAGGGAGTACGCGCGTAC -> GAGGGAGTACGCGCGTACA
CGATAATGAGCAACGAGCT -> GATAATGAGCAACGAGCTG
CGATATCAGATATTTGTGA -> GATATCAGATATTTGTGAT
CGATATGTACACATGGAAC -> GATATGTACACATGGAACT
CGATCCCAATCATAATATC -> GATCCCAATCATAATATCA
CGATCCCACACCTGCGGTC -> GATCCCACACCTGCGGTCA
CGATCCCAGTTGTGATTTA -> GATCCCAGTTGTGATTTAA
CGATCCCATTGGCAACCAC -> GATCCCATTGGCAACCACA
CGATCGGTTTTGCCCCAGG -> GATCGGTTTTGCCCCAGGT
CGATGCAAGCTACACTTGG -> GATGCAAGCTACACTTGGA
CGATTACGCGTTGCATCAC -> GATTACGCGTTGCATCACT
CGATTGCGAACTTATACGA -> GATTGCGAACTTATACGAT
CGCAAAGAGAGCCTCTAAG -> GCAAAGAGAGCCTCTAAGG
CGCAAGCTGATCGCAAAGA -> GCAAGCTGATCGCAAAGAG
CGCACAAGAGGCCTGCGGC -> GCACAAGAGGCCTGCGGCT
CGCACGGATACTCGACTGC -> GCACGGATACTCGACTGCG
CGCAGACGCCCTACGATCG -> GCAGACGCCCTACGATCGG
CGCAGTAGACACCCGACAT -> GCAGTAGACACCCGACATC
CGCAGTTTCACGGCTTTTG -> GCAGTTTCACGGCTTTTGT
CGCCAAGGCCTACGAAATT -> GCCAAGGCCTACGAAATTC
CGCCCTACGATCGGTTTTG -> GCCCTACGATCGGTTTTGC
CGCCCTGAGCTATTCAAGA -> GCCCTGAGCTATTCAAGAG
CGCCCTTACTTGAAGTCTC -> GCCCTTACTTGAAGTCTCA
CGCCGAGACTTTTTAAGCC -> GCCGAGACTTTTTAAGCCA
CGCCGGACGTCAGGACACC -> GCCGGACGTCAGGACACCC
CGCCGTGACTATTAGTGGA -> GCCGTGACTATTAGTGGAC
CGCCTACTTGCCGTCCGAA -> GCCTACTTGCCGTCCGAAA
CGCGCGTACAACTTGTTCT -> GCGCGTACAACTTGTTCTA
CGCGGAGTAAGCGTGCTGA -> GCGGAGTAAGCGTGCTGAC
CGCGTACAACTTGTTCTAC -> GCGTACAACTTGTTCTACA
CGCGTGCGAGGATGGCTTA -> GCGTGCGAGGATGGCTTAT
CGCGTTGCATCACTTTCTG -> GCGTTGCATCACTTTCTGC
CGCTAGAGAGCCGAACTTA -> GCTAGAGAGCCGAACTTAT
CGCTAGTCATGCGGTATGG -> GCTAGTCATGCGGTATGGA
CGCTTCGATTACGCGTTGC -> GCTTCGATTACGCGTTGCA
CGCTTCTTGCCACTCCAGT -> GCTTCTTGCCACTCCAGTG
CGCTTTATTGTAGTGGATG -> GCTTTATTGTAGTGGATGT
CGGAATGATATGCGTAGTA -> GGAATGATATGCGTAGTAT
CGGACCTCTCGCTTCGATT -> GGACCTCTCGCTTCGATTA
CGGACGTCAGGACACCCAC -> GGACGTCAGGACACCCACA
CGGAGCTTTCGGATATCCA -> GGAGCTTTCGGATATCCAC
CGGAGTAAGCGTGCTGACA -> GGAGTAAGCGTGCTGACAG
CGGATACTCGACTGCGGCG -> GGATACTCGACTGCGGCGT
CGGATATCCACAACAGCTG -> GGATATCCACAACAGCTGC
CGGATGACATGTTGAGTAT -> GGATGACATGTTGAGTATC
CGGCAATCCTAATCCCCAC -> GGCAATCCTAATCCCCACG
CGGCGCCTACTTGCCGTCC -> GGCGCCTACTTGCCGTCCG
CGGCGTGAACATGCGTCTA -> GGCGTGAACATGCGTCTAT
CGGCTAAAGATCGATGCAA -> GGCTAAAGATCGATGCAAG
CGGCTTTTGTAGCAAGAAA -> GGCTTTTGTAGCAAGAAAT
CGGGACGAACTTATACGAT -> GGGACGAACTTATACGATC
CGGGAGGTGTCAGTCCTAG -> GGGAGGTGTCAGTCCTAGT
CGGGATCGTTACACTGATG -> GGGATCGTTACACTGATGA
CGGGCAAACCATCGTTTAG -> GGGCAAACCATCGTTTAGG
CGGGCAAGGTCAAGGTCAA -> GGGCAAGGTCAAGGTCAAC
CGGGCAGGCCGGGCAAACC -> GGGCAGGCCGGGCAAACCA
CGGGGAACCCTGCACTATC -> GGGGAACCCTGCACTATCA
CGGGTCAAAACTAGTATCT -> GGGTCAAAACTAGTATCTT
CGGGTGACCCTTAAATATG -> GGGTGACCCTTAAATATGT
CGGGTGATGCTTTGCAGAC -> GGGTGATGCTTTGCAGACA
CGGTATGGAGCTGCAGGCA -> GGTATGGAGCTGCAGGCAC
CGGTCAGTGGCTGGCTAAA -> GGTCAGTGGCTGGCTAAAT
CGGTCCGCGGAGTAAGCGT -> GGTCCGCGGAGTAAGCGTG
CGGTCTCCATTTCGGTGAT -> GGTCTCCATTTCGGTGATG
CGGTCTCTGTGGAGCTCCA -> GGTCTCTGTGGAGCTCCAC
CGGTGACTATTCTCACGGT -> GGTGACTATTCTCACGGTC
CGGTGATGCTCCAGGATCG -> GGTGATGCTCCAGGATCGA
CGGTGCAGGAACGCCAAGG -> GGTGCAGGAACGCCAAGGC
CGGTGCGATATCAGATATT -> GGTGCGATATCAGATATTT
CGGTTGTGGATCATCATGC -> GGTTGTGGATCATCATGCT
CGGTTTTGCCCCAGGTCCG -> GGTTTTGCCCCAGGTCCGT
CGTAAAAAATCAAGACGCA -> GTAAAAAATCAAGACGCAG
CGTAATTGCTCCAGGCATT -> GTAATTGCTCCAGGCATTC
CGTACAACTTGTTCTACAT -> GTACAACTTGTTCTACATT
CGTACGGGCAAGGTCAAGG -> GTACGGGCAAGGTCAAGGT
CGTAGTATTGAATGAAAGG -> GTAGTATTGAATGAAAGGC
CGTATCCCCTGCTGCTCGC -> GTATCCCCTGCTGCTCGCA
CGTCACAAGACCAATGGAG -> GTCACAAGACCAATGGAGG
CGTCACTTCTCGGTTGTGG -> GTCACTTCTCGGTTGTGGA
CGTCAGGACACCCACAGTT -> GTCAGGACACCCACAGTTA
CGTCATGAGCACACTGCCA -> GTCATGAGCACACTGCCAG
CGTCCGAAATATCGATATG -> GTCCGAAATATCGATATGT
CGTCCTGTGACGGCAATCC -> GTCCTGTGACGGCAATCCT
CGTCGTAAAAAATCAAGAC -> GTCGTAAAAAATCAAGACG
CGTCGTTAACGGTGCAGGA -> GTCGTTAACGGTGCAGGAA
CGTCTATAGTCCAATCGTC -> GTCTATAGTCCAATCGTCA
CGTCTGTCCTGTGGTCTTC -> GTCTGTCCTGTGGTCTTCA
CGTGAACATGCGTCTATAG -> GTGAACATGCGTCTATAGT
CGTGACTATTAGTGGACGC -> GTGACTATTAGTGGACGCT
CGTGCGAGGATGGCTTATG -> GTGCGAGGATGGCTTATGC
CGTGCTCGGATGACATGTT -> GTGCTCGGATGACATGTTG
CGTGCTGACAGTGGGGTGA -> GTGCTGACAGTGGGGTGAA
CGTGGGAATGTTGTGGTTC -> GTGGGAATGTTGTGGTTCC
CGTGTAGTGTACGATTGCG -> GTGTAGTGTACGATTGCGA
CGTGTCGCCGGACGTCAGG -> GTGTCGCCGGACGTCAGGA
CGTTAACGGTGCAGGAACG -> GTTAACGGTGCAGGAACGC
CGTTACACTGATGATGATC -> GTTACACTGATGATGATCG
CGTTATTGCCGTGTCGCCG -> GTTATTGCCGTGTCGCCGG
CGTTCGATAATGAGCAACG -> GTTCGATAATGAGCAACGA
CGTTGCATCACTTTCTGCC -> GTTGCATCACTTTCTGCCA
CGTTTAGGGGGATGGTGCT -> GTTTAGGGGGATGGTGCTG
CTAAAGATCGATGCAAGCT -> TAAAGATCGATGCAAGCTA
CTAAAGGGTGAATCCCATA -> TAAAGGGTGAATCCCATAA
CTAAATCTTGGATACAATA -> TAAATCTTGGATACAATAG
CTAAATCTTGGCCAATCGC -> TAAATCTTGGCCAATCGCC
CTAAATCTTGTCCGCAAGC -> TAAATCTTGTCCGCAAGCT
CTAAATCTTGTTGGTTCCT -> TAAATCTTGTTGGTTCCTG
CTAACTAGCCTGTCCTAAA -> TAACTAGCCTGTCCTAAAG
CTAAGAGATCAGTTTGTCA -> TAAGAGATCAGTTTGTCAC
CTAAGGGAATATCGGGTCA -> TAAGGGAATATCGGGTCAA
CTAATCCCCACGGGAGGTG -> TAATCCCCACGGGAGGTGT
CTACACGCGTGCGAGGATG -> TACACGCGTGCGAGGATGG
CTACACTTGGAGCAGTGAT -> TACACTTGGAGCAGTGATA
CTACATTGAACGGGACGAA -> TACATTGAACGGGACGAAC
CTACCGGTCTCTGTGGAGC -> TACCGGTCTCTGTGGAGCT
CTACGAAATTCTTTAATGT -> TACGAAATTCTTTAATGTC
CTACGAACGTGCTCGGATG -> TACGAACGTGCTCGGATGA
CTACGATCGGTTTTGCCCC -> TACGATCGGTTTTGCCCCA
CTACGGGGAACCCTGCACT -> TACGGGGAACCCTGCACTA
CTACTTGCCGTCCGAAATA -> TACTTGCCGTCCGAAATAT
CTAGAGAGCCGAACTTATA -> TAGAGAGCCGAACTTATAC
CTAGCCTGTCCTAAAGGGT -> TAGCCTGTCCTAAAGGGTG
CTAGCGCTAGTCATGCGGT -> TAGCGCTAGTCATGCGGTA
CTAGGGACAGGTCAGTCAG -> TAGGGACAGGTCAGTCAGT
CTAGTACGTGTAGTGTACG -> TAGTACGTGTAGTGTACGA
CTAGTATCTTACTTTCACC -> TAGTATCTTACTTTCACCT
CTAGTCATGCGGTATGGAG -> TAGTCATGCGGTATGGAGC
CTAGTCTCACTTGGTCGGG -> TAGTCTCACTTGGTCGGGC
CTATAGTCCAATCGTCACT -> TATAGTCCAATCGTCACTT
CTATCAGCAGAGGGAGGAT -> TATCAGCAGAGGGAGGATC
CTATCATCCAGCCCGTCGT -> TATCATCCAGCCCGTCGTA
CTATCGGTGCGATATCAGA -> TATCGGTGCGATATCAGAT
CTATGAACTGTGGATTTAA -> TATGAACTGTGGATTTAAG
CTATGTGAGATAACAGAGT -> TATGTGAGATAACAGAGTC
CTATTAGTGGACGCTTTAT -> TATTAGTGGACGCTTTATT
CTATTATCCACTTGATGTT -> TATTATCCACTTGATGTTT
CTATTCAAGAGAGGCTGCC -> TATTCAAGAGAGGCTGCCC
CTATTCGTCATGAGCACAC -> TATTCGTCATGAGCACACT
CTATTCTCACGGTCTCCAT -> TATTCTCACGGTCTCCATT
CTATTTAACCGGGATCGTT -> TATTTAACCGGGATCGTTA
CTCACGGTCTCCATTTCGG -> TCACGGTCTCCATTTCGGT
CTCACTATGAACTGTGGAT -> TCACTATGAACTGTGGATT
CTCACTTGGTCGGGCAGGC -> TCACTTGGTCGGGCAGGCC
CTCAGGTTAAATGTCGCTT -> TCAGGTTAAATGTCGCTTC
CTCATTTGCGTACGGGCAA -> TCATTTGCGTACGGGCAAG
CTCCACCCAGCTAGTCTCA -> TCCACCCAGCTAGTCTCAC
CTCCAGGATCGAATCTGGA -> TCCAGGATCGAATCTGGAA
CTCCAGGCATTCCATTGAA -> TCCAGGCATTCCATTGAAC
CTCCAGTGTCTGCATATGT -> TCCAGTGTCTGCATATGTT
CTCCATTTCGGTGATGCTC -> TCCATTTCGGTGATGCTCC
CTCCCGGACCTCTCGCTTC -> TCCCGGACCTCTCGCTTCG
CTCCTAGCGCTAGTCATGC -> TCCTAGCGCTAGTCATGCG
CTCGAACTTATACGATCCC -> TCGAACTTATACGATCCCA
CTCGACTGCGGCGTGAACA -> TCGACTGCGGCGTGAACAT
CTCGCAGTAGACACCCGAC -> TCGCAGTAGACACCCGACA
CTCGCTTCGATTACGCGTT -> TCGCTTCGATTACGCGTTG
CTCGGATGACATGTTGAGT -> TCGGATGACATGTTGAGTA
CTCGGTTGTGGATCATCAT -> TCGGTTGTGGATCATCATG
CTCGTCGTTAACGGTGCAG -> TCGTCGTTAACGGTGCAGG
CTCTAAGGGAATATCGGGT -> TCTAAGGGAATATCGGGTC
CTCTCGCTTCGATTACGCG -> TCTCGCTTCGATTACGCGT
CTCTCGTCGTTAACGGTGC -> TCTCGTCGTTAACGGTGCA
CTCTGTGGAGCTCCACCCA -> TCTGTGGAGCTCCACCCAG
CTCTGTGTGATGCATAGCA -> TCTGTGTGATGCATAGCAC
CTCTTATCCCCGGAATGAT -> TCTTATCCCCGGAATGATA
CTGACAGAGAATCGCCGAG -> TGACAGAGAATCGCCGAGA
CTGACAGTGGGGTGAAGGA -> TGACAGTGGGGTGAAGGAC
CTGAGCTATTCAAGAGAGG -> TGAGCTATTCAAGAGAGGC
CTGATAATCGTGGGAATGT -> TGATAATCGTGGGAATGTT
CTGATCGCAAAGAGAGCCT -> TGATCGCAAAGAGAGCCTC
CTGATGATGATCGCTAGAG -> TGATGATGATCGCTAGAGA
CTGCACGCCGTGACTATTA -> TGCACGCCGTGACTATTAG
CTGCACTATCATCCAGCCC -> TGCACTATCATCCAGCCCG
CTGCAGGCACAGAAAACCC -> TGCAGGCACAGAAAACCCC
CTGCATATGTTAAACACTG -> TGCATATGTTAAACACTGT
CTGCCAGACACCCTCAGGT -> TGCCAGACACCCTCAGGTT
CTGCCAGCTTCCACAGGCG -> TGCCAGCTTCCACAGGCGC
CTGCCCTGTATAGGCATGT -> TGCCCTGTATAGGCATGTT
CTGCGGCGTGAACATGCGT -> TGCGGCGTGAACATGCGTC
CTGCGGCTAAAGATCGATG -> TGCGGCTAAAGATCGATGC
CTGCGGTCAGTGGCTGGCT -> TGCGGTCAGTGGCTGGCTA
CTGCTCGCAGTAGACACCC -> TGCTCGCAGTAGACACCCG
CTGCTGCTCGCAGTAGACA -> TGCTGCTCGCAGTAGACAC
CTGGCTAAATCTTGGATAC -> TGGCTAAATCTTGGATACA
CTGGCTAAATCTTGGCCAA -> TGGCTAAATCTTGGCCAAT
CTGGCTAAATCTTGTCCGC -> TGGCTAAATCTTGTCCGCA
CTGGCTAAATCTTGTTGGT -> TGGCTAAATCTTGTTGGTT
CTGGTACACTGTGCCACTA -> TGGTACACTGTGCCACTAT
CTGGTCACAAAAATAGGAG -> TGGTCACAAAAATAGGAGC
CTGTAAGCATTCGAGGATT -> TGTAAGCATTCGAGGATTC
CTGTATAGGCATGTTATAC -> TGTATAGGCATGTTATACC
CTGTCCTAAAGGGTGAATC -> TGTCCTAAAGGGTGAATCC
CTGTCCTGTGGTCTTCACC -> TGTCCTGTGGTCTTCACCC
CTGTCGAGGGAGTACGCGC -> TGTCGAGGGAGTACGCGCG
CTGTCTCACTATGAACTGT -> TGTCTCACTATGAACTGTG
CTGTGACGGCAATCCTAAT -> TGTGACGGCAATCCTAATC
CTGTGCCACTATTATCCAC -> TGTGCCACTATTATCCACT
CTGTGGAGCTCCACCCAGC -> TGTGGAGCTCCACCCAGCT
CTGTGGATTTAAGCTTTGA -> TGTGGATTTAAGCTTTGAC
CTGTGGTCTTCACCCCCCG -> TGTGGTCTTCACCCCCCGA
CTGTGTGATGCATAGCACT -> TGTGTGATGCATAGCACTG
CTTAAATATGTACGTTATT -> TTAAATATGTACGTTATTG
CTTAACGGCGCCTACTTGC -> TTAACGGCGCCTACTTGCC
CTTACTGACAGAGAATCGC -> TTACTGACAGAGAATCGCC
CTTACTTGAAGTCTCATTT -> TTACTTGAAGTCTCATTTG
CTTACTTTCACCTTATTTA -> TTACTTTCACCTTATTTAA
CTTATACGATCCCAATCAT -> TTATACGATCCCAATCATA
CTTATACGATCCCACACCT -> TTATACGATCCCACACCTG
CTTATACGATCCCAGTTGT -> TTATACGATCCCAGTTGTG
CTTATACGATCCCATTGGC -> TTATACGATCCCATTGGCA
CTTATCCCCGGAATGATAT -> TTATCCCCGGAATGATATG
CTTATGCTCCCGGACCTCT -> TTATGCTCCCGGACCTCTC
CTTATTTAATGAGTTTAAT -> TTATTTAATGAGTTTAATT
CTTCACCCCCCGAATAGGA -> TTCACCCCCCGAATAGGAC
CTTCCACAGGCGCACGGAT -> TTCCACAGGCGCACGGATA
CTTCCCATACCGAGGGACT -> TTCCCATACCGAGGGACTA
CTTCGATTACGCGTTGCAT -> TTCGATTACGCGTTGCATC
CTTCTCGGTTGTGGATCAT -> TTCTCGGTTGTGGATCATC
CTTCTTGCCACTCCAGTGT -> TTCTTGCCACTCCAGTGTC
CTTGAAGTCTCATTTGCGT -> TTGAAGTCTCATTTGCGTA
CTTGATGTTTCGCCCTGAG -> TTGATGTTTCGCCCTGAGC
CTTGCCACTCCAGTGTCTG -> TTGCCACTCCAGTGTCTGC
CTTGCCGTCCGAAATATCG -> TTGCCGTCCGAAATATCGA
CTTGGAGCAGTGATATCTT -> TTGGAGCAGTGATATCTTA
CTTGGATACAATAGGGAGG -> TTGGATACAATAGGGAGGA
CTTGGCCAATCGCCCTTAC -> TTGGCCAATCGCCCTTACT
CTTGGCCCTATCGGTGCGA -> TTGGCCCTATCGGTGCGAT
CTTGGTCGGGCAGGCCGGG -> TTGGTCGGGCAGGCCGGGC
CTTGTCCGCAAGCTGATCG -> TTGTCCGCAAGCTGATCGC
CTTGTTCTACATTGAACGG -> TTGTTCTACATTGAACGGG
CTTGTTGGTTCCTGTCTCA -> TTGTTGGTTCCTGTCTCAC
CTTTAATGTCCTCGAACTT -> TTTAATGTCCTCGAACTTA
CTTTATTGTAGTGGATGTC -> TTTATTGTAGTGGATGTCC
CTTTCACCTTATTTAATGA -> TTTCACCTTATTTAATGAG
CTTTCGGATATCCACAACA -> TTTCGGATATCCACAACAG
CTTTCTGCCAGCTTCCACA -> TTTCTGCCAGCTTCCACAG
CTTTGACCCCGTATCCCCT -> TTTGACCCCGTATCCCCTG
CTTTGATGGTGTGTCGGGT -> TTTGATGGTGTGTCGGGTG
CTTTGCAGACAGACCAATG -> TTTGCAGACAGACCAATGG
CTTTTGTAGCAAGAAATAA -> TTTTGTAGCAAGAAATAAA
CTTTTTAAGCCATTTCCTC -> TTTTTAAGCCATTTCCTCT
GAAAACCCCGGAGCTTTCG -> AAAACCCCGGAGCTTTCGG
GAAAGGCCCCGTCCTGTGA -> AAAGGCCCCGTCCTGTGAC
GAAATAAATGCAGAGTAGC -> AAATAAATGCAGAGTAGCG
GAAATATCGATATGTACAC -> AAATATCGATATGTACACA
GAAATTCTTTAATGTCCTC -> AAATTCTTTAATGTCCTCG
GAACATGCCAATCTCCTAG -> AACATGCCAATCTCCTAGC
GAACATGCGTCTATAGTCC -> AACATGCGTCTATAGTCCA
GAACCCTGCACTATCATCC -> AACCCTGCACTATCATCCA
GAACGCCAAGGCCTACGAA -> AACGCCAAGGCCTACGAAA
GAACGGGACGAACTTATAC -> AACGGGACGAACTTATACG
GAACGTGCTCGGATGACAT -> AACGTGCTCGGATGACATG
GAACTACGAACGTGCTCGG -> AACTACGAACGTGCTCGGA
GAACTGTGGATTTAAGCTT -> AACTGTGGATTTAAGCTTT
GAACTTATACGATCCCAAT -> AACTTATACGATCCCAATC
GAACTTATACGATCCCACA -> AACTTATACGATCCCACAC
GAACTTATACGATCCCAGT -> AACTTATACGATCCCAGTT
GAACTTATACGATCCCATT -> AACTTATACGATCCCATTG
GAAGCCTTACTGACAGAGA -> AAGCCTTACTGACAGAGAA
GAAGGACCATCATCAGGAT -> AAGGACCATCATCAGGATT
GAAGTAACTCTGTGTGATG -> AAGTAACTCTGTGTGATGC
GAAGTCTCATTTGCGTACG -> AAGTCTCATTTGCGTACGG
GAATAGGACTATTCGTCAT -> AATAGGACTATTCGTCATG
GAATATCGGGTCAAAACTA -> AATATCGGGTCAAAACTAG
GAATCCCATAAAAGACTTT -> AATCCCATAAAAGACTTTG
GAATCGCAGACGCCCTACG -> AATCGCAGACGCCCTACGA
GAATCGCCGAGACTTTTTA -> AATCGCCGAGACTTTTTAA
GAATCTGGAACTCAGGGGG -> AATCTGGAACTCAGGGGGG
GAATCTTGGCCCTATCGGT -> AATCTTGGCCCTATCGGTG
GAATGAAAGGCCCCGTCCT -> AATGAAAGGCCCCGTCCTG
GAATGATATGCGTAGTATT -> AATGATATGCGTAGTATTG
GAATGTTGTGGTTCCCTCT -> AATGTTGTGGTTCCCTCTT
GACACCCACAGTTACCCCT -> ACACCCACAGTTACCCCTA
GACACCCGACATCCACGCA -> ACACCCGACATCCACGCAC
GACACCCTCAGGTTAAATG -> ACACCCTCAGGTTAAATGT
GACAGACCAATGGGAGCAC -> ACAGACCAATGGGAGCACG
GACAGAGAATCGCCGAGAC -> ACAGAGAATCGCCGAGACT
GACAGGTCAGTCAGTGGAA -> ACAGGTCAGTCAGTGGAAG
GACAGTGGGGTGAAGGACC -> ACAGTGGGGTGAAGGACCA
GACATCCACGCACAAGAGG -> ACATCCACGCACAAGAGGC
GACATGGAATCTTGGCCCT -> ACATGGAATCTTGGCCCTA
GACATGTTGAGTATCTGAT -> ACATGTTGAGTATCTGATA
GACCAATGGAGGGTTAAAC -> ACCAATGGAGGGTTAAACT
GACCAATGGGAGCACGGTC -> ACCAATGGGAGCACGGTCC
GACCATCATCAGGATTGCG -> ACCATCATCAGGATTGCGT
GACCCCGTATCCCCTGCTG -> ACCCCGTATCCCCTGCTGC
GACCCTTAAATATGTACGT -> ACCCTTAAATATGTACGTT
GACCTCTCGCTTCGATTAC -> ACCTCTCGCTTCGATTACG
GACGAACTTATACGATCCC -> ACGAACTTATACGATCCCA
GACGAGCTAACTAGCCTGT -> ACGAGCTAACTAGCCTGTC
GACGCAGTTTCACGGCTTT -> ACGCAGTTTCACGGCTTTT
GACGCCCTACGATCGGTTT -> ACGCCCTACGATCGGTTTT
GACGCTTTATTGTAGTGGA -> ACGCTTTATTGTAGTGGAT
GACGGCAATCCTAATCCCC -> ACGGCAATCCTAATCCCCA
GACGTCAGGACACCCACAG -> ACGTCAGGACACCCACAGT
GACTAAGAGATCAGTTTGT -> ACTAAGAGATCAGTTTGTC
GACTATTAGTGGACGCTTT -> ACTATTAGTGGACGCTTTA
GACTATTCGTCATGAGCAC -> ACTATTCGTCATGAGCACA
GACTATTCTCACGGTCTCC -> ACTATTCTCACGGTCTCCA
GACTGCGGCGTGAACATGC -> ACTGCGGCGTGAACATGCG
GACTTTGATGGTGTGTCGG -> ACTTTGATGGTGTGTCGGG
GACTTTTTAAGCCATTTCC -> ACTTTTTAAGCCATTTCCT
GAGAATCGCCGAGACTTTT -> AGAATCGCCGAGACTTTTT
GAGACTTTTTAAGCCATTT -> AGACTTTTTAAGCCATTTC
GAGAGCCGAACTTATACGA -> AGAGCCGAACTTATACGAT
GAGAGCCTCTAAGGGAATA -> AGAGCCTCTAAGGGAATAT
GAGAGGCTGCCCTGTATAG -> AGAGGCTGCCCTGTATAGG
GAGATAACAGAGTCCAAGG -> AGATAACAGAGTCCAAGGG
GAGATCAGTTTGTCACCCG -> AGATCAGTTTGTCACCCGA
GAGCAACGAGCTGTCGAGG -> AGCAACGAGCTGTCGAGGG
GAGCACACTGCCAGACACC -> AGCACACTGCCAGACACCC
GAGCACGGTCCGCGGAGTA -> AGCACGGTCCGCGGAGTAA
GAGCAGTGATATCTTAACG -> AGCAGTGATATCTTAACGG
GAGCCGAACTTATACGATC -> AGCCGAACTTATACGATCC
GAGCCTCTAAGGGAATATC -> AGCCTCTAAGGGAATATCG
GAGCTAACTAGCCTGTCCT -> AGCTAACTAGCCTGTCCTA
GAGCTATGTGAGATAACAG -> AGCTATGTGAGATAACAGA
GAGCTATTCAAGAGAGGCT -> AGCTATTCAAGAGAGGCTG
GAGCTCCACCCAGCTAGTC -> AGCTCCACCCAGCTAGTCT
GAGCTGCAGGCACAGAAAA -> AGCTGCAGGCACAGAAAAC
GAGCTGTCGAGGGAGTACG -> AGCTGTCGAGGGAGTACGC
GAGCTTTCGGATATCCACA -> AGCTTTCGGATATCCACAA
GAGGAATCGCAGACGCCCT -> AGGAATCGCAGACGCCCTA
GAGGATCTACACGCGTGCG -> AGGATCTACACGCGTGCGA
GAGGATGGCTTATGCTCCC -> AGGATGGCTTATGCTCCCG
GAGGATTCCCCCAGCAGTA -> AGGATTCCCCCAGCAGTAC
GAGGCCTGCGGCTAAAGAT -> AGGCCTGCGGCTAAAGATC
GAGGCTGCCCTGTATAGGC -> AGGCTGCCCTGTATAGGCA
GAGGGACTAAGAGATCAGT -> AGGGACTAAGAGATCAGTT
GAGGGAGGATCTACACGCG -> AGGGAGGATCTACACGCGT
GAGGGAGTACGCGCGTACA -> AGGGAGTACGCGCGTACAA
GAGGGTTAAACTATTTAAC -> AGGGTTAAACTATTTAACC
GAGGTGTCAGTCCTAGTAC -> AGGTGTCAGTCCTAGTACG
GAGTAAGCGTGCTGACAGT -> AGTAAGCGTGCTGACAGTG
GAGTACGCGCGTACAACTT -> AGTACGCGCGTACAACTTG
GAGTAGCGTCTGTCCTGTG -> AGTAGCGTCTGTCCTGTGG
GAGTATCTGATAATCGTGG -> AGTATCTGATAATCGTGGG
GAGTCCAAGGGCCCATTGG -> AGTCCAAGGGCCCATTGGT
GAGTTTAATTTTAAGGACA -> AGTTTAATTTTAAGGACAT
GATAACAGAGTCCAAGGGC -> ATAACAGAGTCCAAGGGCC
GATAATCGTGGGAATGTTG -> ATAATCGTGGGAATGTTGT
GATAATGAGCAACGAGCTG -> ATAATGAGCAACGAGCTGT
GATACAATAGGGAGGAATC -> ATACAATAGGGAGGAATCG
GATACTCGACTGCGGCGTG -> ATACTCGACTGCGGCGTGA
GATATCAGATATTTGTGAT -> ATATCAGATATTTGTGATG
GATATCCACAACAGCTGCA -> ATATCCACAACAGCTGCAC
GATATCTTAACGGCGCCTA -> ATATCTTAACGGCGCCTAC
GATATGCGTAGTATTGAAT -> ATATGCGTAGTATTGAATG
GATATGTACACATGGAACT -> ATATGTACACATGGAACTA
GATATTTGTGATGCCAGGT -> ATATTTGTGATGCCAGGTG
GATCAGTTTGTCACCCGAA -> ATCAGTTTGTCACCCGAAG
GATCATCATGCTTCCCATA -> ATCATCATGCTTCCCATAC
GATCCCAATCATAATATCA -> ATCCCAATCATAATATCAG
GATCCCACACCTGCGGTCA -> ATCCCACACCTGCGGTCAG
GATCCCAGTTGTGATTTAA -> ATCCCAGTTGTGATTTAAG
GATCCCATTGGCAACCACA -> ATCCCATTGGCAACCACAG
GATCGAATCTGGAACTCAG -> ATCGAATCTGGAACTCAGG
GATCGATGCAAGCTACACT -> ATCGATGCAAGCTACACTT
GATCGCAAAGAGAGCCTCT -> ATCGCAAAGAGAGCCTCTA
GATCGCTAGAGAGCCGAAC -> ATCGCTAGAGAGCCGAACT
GATCGGTTTTGCCCCAGGT -> ATCGGTTTTGCCCCAGGTC
GATCGTTACACTGATGATG -> ATCGTTACACTGATGATGA
GATCTACACGCGTGCGAGG -> ATCTACACGCGTGCGAGGA
GATGACATGTTGAGTATCT -> ATGACATGTTGAGTATCTG
GATGATCGCTAGAGAGCCG -> ATGATCGCTAGAGAGCCGA
GATGATGATCGCTAGAGAG -> ATGATGATCGCTAGAGAGC
GATGCAAGCTACACTTGGA -> ATGCAAGCTACACTTGGAG
GATGCATAGCACTGGTACA -> ATGCATAGCACTGGTACAC
GATGCCAGGTGCCTATCAG -> ATGCCAGGTGCCTATCAGC
GATGCTCCAGGATCGAATC -> ATGCTCCAGGATCGAATCT
GATGCTTTGCAGACAGACC -> ATGCTTTGCAGACAGACCA
GATGGCTTATGCTCCCGGA -> ATGGCTTATGCTCCCGGAC
GATGGTGCTGGTCACAAAA -> ATGGTGCTGGTCACAAAAA
GATGGTGTGTCGGGTGATG -> ATGGTGTGTCGGGTGATGC
GATGTCCTACCGGTCTCTG -> ATGTCCTACCGGTCTCTGT
GATGTTTCGCCCTGAGCTA -> ATGTTTCGCCCTGAGCTAT
GATTACGCGTTGCATCACT -> ATTACGCGTTGCATCACTT
GATTCCCCCAGCAGTACGA -> ATTCCCCCAGCAGTACGAC
GATTGCGAACTTATACGAT -> ATTGCGAACTTATACGATC
GATTGCGTTCGATAATGAG -> ATTGCGTTCGATAATGAGC
GATTTAAGCTTTGACCCCG -> ATTTAAGCTTTGACCCCGT
GATTTAAGTGGCTGGCTAA -> ATTTAAGTGGCTGGCTAAA
GCAAACCATCGTTTAGGGG -> CAAACCATCGTTTAGGGGG
GCAAAGAGAGCCTCTAAGG -> CAAAGAGAGCCTCTAAGGG
GCAACCACAGTGGCTGGCT -> CAACCACAGTGGCTGGCTA
GCAACGAGCTGTCGAGGGA -> CAACGAGCTGTCGAGGGAG
GCAAGAAATAAATGCAGAG -> CAAGAAATAAATGCAGAGT
GCAAGCTACACTTGGAGCA -> CAAGCTACACTTGGAGCAG
GCAAGCTGATCGCAAAGAG -> CAAGCTGATCGCAAAGAGA
GCAAGGTCAAGGTCAACCG -> CAAGGTCAAGGTCAACCGG
GCAATCCTAATCCCCACGG -> CAATCCTAATCCCCACGGG
GCACAAGAGGCCTGCGGCT -> CACAAGAGGCCTGCGGCTA
GCACACTGCCAGACACCCT -> CACACTGCCAGACACCCTC
GCACAGAAAACCCCGGAGC -> CACAGAAAACCCCGGAGCT
GCACGCCGTGACTATTAGT -> CACGCCGTGACTATTAGTG
GCACGGATACTCGACTGCG -> CACGGATACTCGACTGCGG
GCACGGTCCGCGGAGTAAG -> CACGGTCCGCGGAGTAAGC
GCACTATCATCCAGCCCGT -> CACTATCATCCAGCCCGTC
GCACTGGTACACTGTGCCA -> CACTGGTACACTGTGCCAC
GCAGACAGACCAATGGGAG -> CAGACAGACCAATGGGAGC
GCAGACGCCCTACGATCGG -> CAGACGCCCTACGATCGGT
GCAGAGGGAGGATCTACAC -> CAGAGGGAGGATCTACACG
GCAGAGTAGCGTCTGTCCT -> CAGAGTAGCGTCTGTCCTG
GCAGGAACGCCAAGGCCTA -> CAGGAACGCCAAGGCCTAC
GCAGGCACAGAAAACCCCG -> CAGGCACAGAAAACCCCGG
GCAGGCCGGGCAAACCATC -> CAGGCCGGGCAAACCATCG
GCAGTACGACGAGCTAACT -> CAGTACGACGAGCTAACTA
GCAGTAGACACCCGACATC -> CAGTAGACACCCGACATCC
GCAGTGATATCTTAACGGC -> CAGTGATATCTTAACGGCG
GCAGTTTCACGGCTTTTGT -> CAGTTTCACGGCTTTTGTA
GCATAGCACTGGTACACTG -> CATAGCACTGGTACACTGT
GCATATGTTAAACACTGTA -> CATATGTTAAACACTGTAA
GCATCACTTTCTGCCAGCT -> CATCACTTTCTGCCAGCTT
GCATGTTATACCTACGGGG -> CATGTTATACCTACGGGGA
GCATTCCATTGAACATGCC -> CATTCCATTGAACATGCCA
GCATTCGAGGATTCCCCCA -> CATTCGAGGATTCCCCCAG
GCCAAGGCCTACGAAATTC -> CCAAGGCCTACGAAATTCT
GCCAATCGCCCTTACTTGA -> CCAATCGCCCTTACTTGAA
GCCAATCTCCTAGCGCTAG -> CCAATCTCCTAGCGCTAGT
GCCACTATTATCCACTTGA -> CCACTATTATCCACTTGAT
GCCACTCCAGTGTCTGCAT -> CCACTCCAGTGTCTGCATA
GCCAGACACCCTCAGGTTA -> CCAGACACCCTCAGGTTAA
GCCAGCTTCCACAGGCGCA -> CCAGCTTCCACAGGCGCAC
GCCAGGTGCCTATCAGCAG -> CCAGGTGCCTATCAGCAGA
GCCATTTCCTCTCGTCGTT -> CCATTTCCTCTCGTCGTTA
GCCCATTGGTACGGTGACT -> CCCATTGGTACGGTGACTA
GCCCCAGGTCCGTAATTGC -> CCCCAGGTCCGTAATTGCT
GCCCCGTCCTGTGACGGCA -> CCCCGTCCTGTGACGGCAA
GCCCGTCGTAAAAAATCAA -> CCCGTCGTAAAAAATCAAG
GCCCTACGATCGGTTTTGC -> CCCTACGATCGGTTTTGCC
GCCCTATCGGTGCGATATC -> CCCTATCGGTGCGATATCA
GCCCTGAGCTATTCAAGAG -> CCCTGAGCTATTCAAGAGA
GCCCTGTATAGGCATGTTA -> CCCTGTATAGGCATGTTAT
GCCCTTACTTGAAGTCTCA -> CCCTTACTTGAAGTCTCAT
GCCGAACTTATACGATCCC -> CCGAACTTATACGATCCCA
GCCGAGACTTTTTAAGCCA -> CCGAGACTTTTTAAGCCAT
GCCGGACGTCAGGACACCC -> CCGGACGTCAGGACACCCA
GCCGGGCAAACCATCGTTT -> CCGGGCAAACCATCGTTTA
GCCGTCCGAAATATCGATA -> CCGTCCGAAATATCGATAT
GCCGTGACTATTAGTGGAC -> CCGTGACTATTAGTGGACG
GCCGTGTCGCCGGACGTCA -> CCGTGTCGCCGGACGTCAG
GCCTACGAAATTCTTTAAT -> CCTACGAAATTCTTTAATG
GCCTACTTGCCGTCCGAAA -> CCTACTTGCCGTCCGAAAT
GCCTATCAGCAGAGGGAGG -> CCTATCAGCAGAGGGAGGA
GCCTCTAAGGGAATATCGG -> CCTCTAAGGGAATATCGGG
GCCTGCGGCTAAAGATCGA -> CCTGCGGCTAAAGATCGAT
GCCTGTCCTAAAGGGTGAA -> CCTGTCCTAAAGGGTGAAT
GCCTTACTGACAGAGAATC -> CCTTACTGACAGAGAATCG
GCGAACTTATACGATCCCA -> CGAACTTATACGATCCCAG
GCGAGGATGGCTTATGCTC -> CGAGGATGGCTTATGCTCC
GCGATATCAGATATTTGTG -> CGATATCAGATATTTGTGA
GCGCACGGATACTCGACTG -> CGCACGGATACTCGACTGC
GCGCCTACTTGCCGTCCGA -> CGCCTACTTGCCGTCCGAA
GCGCGTACAACTTGTTCTA -> CGCGTACAACTTGTTCTAC
GCGCTAGTCATGCGGTATG -> CGCTAGTCATGCGGTATGG
GCGGAGTAAGCGTGCTGAC -> CGGAGTAAGCGTGCTGACA
GCGGCGTGAACATGCGTCT -> CGGCGTGAACATGCGTCTA
GCGGCTAAAGATCGATGCA -> CGGCTAAAGATCGATGCAA
GCGGTATGGAGCTGCAGGC -> CGGTATGGAGCTGCAGGCA
GCGGTCAGTGGCTGGCTAA -> CGGTCAGTGGCTGGCTAAA
GCGTACAACTTGTTCTACA -> CGTACAACTTGTTCTACAT
GCGTACGGGCAAGGTCAAG -> CGTACGGGCAAGGTCAAGG
GCGTAGTATTGAATGAAAG -> CGTAGTATTGAATGAAAGG
GCGTCTATAGTCCAATCGT -> CGTCTATAGTCCAATCGTC
GCGTCTGTCCTGTGGTCTT -> CGTCTGTCCTGTGGTCTTC
GCGTGAACATGCGTCTATA -> CGTGAACATGCGTCTATAG
GCGTGCGAGGATGGCTTAT -> CGTGCGAGGATGGCTTATG
GCGTGCTGACAGTGGGGTG -> CGTGCTGACAGTGGGGTGA
GCGTTCGATAATGAGCAAC -> CGTTCGATAATGAGCAACG
GCGTTGCATCACTTTCTGC -> CGTTGCATCACTTTCTGCC
GCTAAAGATCGATGCAAGC -> CTAAAGATCGATGCAAGCT
GCTAAATCTTGGATACAAT -> CTAAATCTTGGATACAATA
GCTAAATCTTGGCCAATCG -> CTAAATCTTGGCCAATCGC
GCTAAATCTTGTCCGCAAG -> CTAAATCTTGTCCGCAAGC
GCTAAATCTTGTTGGTTCC -> CTAAATCTTGTTGGTTCCT
GCTAACTAGCCTGTCCTAA -> CTAACTAGCCTGTCCTAAA
GCTACACTTGGAGCAGTGA -> CTACACTTGGAGCAGTGAT
GCTAGAGAGCCGAACTTAT -> CTAGAGAGCCGAACTTATA
GCTAGTCATGCGGTATGGA -> CTAGTCATGCGGTATGGAG
GCTAGTCTCACTTGGTCGG -> CTAGTCTCACTTGGTCGGG
GCTATGTGAGATAACAGAG -> CTATGTGAGATAACAGAGT
GCTATTCAAGAGAGGCTGC -> CTATTCAAGAGAGGCTGCC
GCTCCACCCAGCTAGTCTC -> CTCCACCCAGCTAGTCTCA
GCTCCAGGATCGAATCTGG -> CTCCAGGATCGAATCTGGA
GCTCCAGGCATTCCATTGA -> CTCCAGGCATTCCATTGAA
GCTCCCGGACCTCTCGCTT -> CTCCCGGACCTCTCGCTTC
GCTCGCAGTAGACACCCGA -> CTCGCAGTAGACACCCGAC
GCTCGGATGACATGTTGAG -> CTCGGATGACATGTTGAGT
GCTGACAGTGGGGTGAAGG -> CTGACAGTGGGGTGAAGGA
GCTGATCGCAAAGAGAGCC -> CTGATCGCAAAGAGAGCCT
GCTGCACGCCGTGACTATT -> CTGCACGCCGTGACTATTA
GCTGCAGGCACAGAAAACC -> CTGCAGGCACAGAAAACCC
GCTGCCCTGTATAGGCATG -> CTGCCCTGTATAGGCATGT
GCTGCTCGCAGTAGACACC -> CTGCTCGCAGTAGACACCC
GCTGGCTAAATCTTGGATA -> CTGGCTAAATCTTGGATAC
GCTGGCTAAATCTTGGCCA -> CTGGCTAAATCTTGGCCAA
GCTGGCTAAATCTTGTCCG -> CTGGCTAAATCTTGTCCGC
GCTGGCTAAATCTTGTTGG -> CTGGCTAAATCTTGTTGGT
GCTGGTCACAAAAATAGGA -> CTGGTCACAAAAATAGGAG
GCTGTCGAGGGAGTACGCG -> CTGTCGAGGGAGTACGCGC
GCTTATGCTCCCGGACCTC -> CTTATGCTCCCGGACCTCT
GCTTCCACAGGCGCACGGA -> CTTCCACAGGCGCACGGAT
GCTTCCCATACCGAGGGAC -> CTTCCCATACCGAGGGACT
GCTTCGATTACGCGTTGCA -> CTTCGATTACGCGTTGCAT
GCTTCTTGCCACTCCAGTG -> CTTCTTGCCACTCCAGTGT
GCTTTATTGTAGTGGATGT -> CTTTATTGTAGTGGATGTC
GCTTTCGGATATCCACAAC -> CTTTCGGATATCCACAACA
GCTTTGACCCCGTATCCCC -> CTTTGACCCCGTATCCCCT
GCTTTGCAGACAGACCAAT -> CTTTGCAGACAGACCAATG
GCTTTTGTAGCAAGAAATA -> CTTTTGTAGCAAGAAATAA
GGAACCCTGCACTATCATC -> GAACCCTGCACTATCATCC
GGAACGCCAAGGCCTACGA -> GAACGCCAAGGCCTACGAA
GGAACTACGAACGTGCTCG -> GAACTACGAACGTGCTCGG
GGAAGCCTTACTGACAGAG -> GAAGCCTTACTGACAGAGA
GGAATATCGGGTCAAAACT -> GAATATCGGGTCAAAACTA
GGAATCGCAGACGCCCTAC -> GAATCGCAGACGCCCTACG
GGAATCTTGGCCCTATCGG -> GAATCTTGGCCCTATCGGT
GGAATGATATGCGTAGTAT -> GAATGATATGCGTAGTATT
GGAATGTTGTGGTTCCCTC -> GAATGTTGTGGTTCCCTCT
GGACACCCACAGTTACCCC -> GACACCCACAGTTACCCCT
GGACAGGTCAGTCAGTGGA -> GACAGGTCAGTCAGTGGAA
GGACATGGAATCTTGGCCC -> GACATGGAATCTTGGCCCT
GGACCATCATCAGGATTGC -> GACCATCATCAGGATTGCG
GGACCTCTCGCTTCGATTA -> GACCTCTCGCTTCGATTAC
GGACGAACTTATACGATCC -> GACGAACTTATACGATCCC
GGACGCTTTATTGTAGTGG -> GACGCTTTATTGTAGTGGA
GGACGTCAGGACACCCACA -> GACGTCAGGACACCCACAG
GGACTAAGAGATCAGTTTG -> GACTAAGAGATCAGTTTGT
GGACTATTCGTCATGAGCA -> GACTATTCGTCATGAGCAC
GGAGCACGGTCCGCGGAGT -> GAGCACGGTCCGCGGAGTA
GGAGCAGTGATATCTTAAC -> GAGCAGTGATATCTTAACG
GGAGCTATGTGAGATAACA -> GAGCTATGTGAGATAACAG
GGAGCTCCACCCAGCTAGT -> GAGCTCCACCCAGCTAGTC
GGAGCTGCAGGCACAGAAA -> GAGCTGCAGGCACAGAAAA
GGAGCTTTCGGATATCCAC -> GAGCTTTCGGATATCCACA
GGAGGAATCGCAGACGCCC -> GAGGAATCGCAGACGCCCT
GGAGGATCTACACGCGTGC -> GAGGATCTACACGCGTGCG
GGAGGGTTAAACTATTTAA -> GAGGGTTAAACTATTTAAC
GGAGGTGTCAGTCCTAGTA -> GAGGTGTCAGTCCTAGTAC
GGAGTAAGCGTGCTGACAG -> GAGTAAGCGTGCTGACAGT
GGAGTACGCGCGTACAACT -> GAGTACGCGCGTACAACTT
GGATACAATAGGGAGGAAT -> GATACAATAGGGAGGAATC
GGATACTCGACTGCGGCGT -> GATACTCGACTGCGGCGTG
GGATATCCACAACAGCTGC -> GATATCCACAACAGCTGCA
GGATCATCATGCTTCCCAT -> GATCATCATGCTTCCCATA
GGATCGAATCTGGAACTCA -> GATCGAATCTGGAACTCAG
GGATCGTTACACTGATGAT -> GATCGTTACACTGATGATG
GGATCTACACGCGTGCGAG -> GATCTACACGCGTGCGAGG
GGATGACATGTTGAGTATC -> GATGACATGTTGAGTATCT
GGATGGCTTATGCTCCCGG -> GATGGCTTATGCTCCCGGA
GGATGGTGCTGGTCACAAA -> GATGGTGCTGGTCACAAAA
GGATGTCCTACCGGTCTCT -> GATGTCCTACCGGTCTCTG
GGATTCCCCCAGCAGTACG -> GATTCCCCCAGCAGTACGA
GGATTGCGTTCGATAATGA -> GATTGCGTTCGATAATGAG
GGATTTAAGCTTTGACCCC -> GATTTAAGCTTTGACCCCG
GGCAAACCATCGTTTAGGG -> GCAAACCATCGTTTAGGGG
GGCAACCACAGTGGCTGGC -> GCAACCACAGTGGCTGGCT
GGCAAGGTCAAGGTCAACC -> GCAAGGTCAAGGTCAACCG
GGCAATCCTAATCCCCACG -> GCAATCCTAATCCCCACGG
GGCACAGAAAACCCCGGAG -> GCACAGAAAACCCCGGAGC
GGCAGGCCGGGCAAACCAT -> GCAGGCCGGGCAAACCATC
GGCATGTTATACCTACGGG -> GCATGTTATACCTACGGGG
GGCATTCCATTGAACATGC -> GCATTCCATTGAACATGCC
GGCCAATCGCCCTTACTTG -> GCCAATCGCCCTTACTTGA
GGCCCATTGGTACGGTGAC -> GCCCATTGGTACGGTGACT
GGCCCCGTCCTGTGACGGC -> GCCCCGTCCTGTGACGGCA
GGCCCTATCGGTGCGATAT -> GCCCTATCGGTGCGATATC
GGCCGGGCAAACCATCGTT -> GCCGGGCAAACCATCGTTT
GGCCTACGAAATTCTTTAA -> GCCTACGAAATTCTTTAAT
GGCCTGCGGCTAAAGATCG -> GCCTGCGGCTAAAGATCGA
GGCGCACGGATACTCGACT -> GCGCACGGATACTCGACTG
GGCGCCTACTTGCCGTCCG -> GCGCCTACTTGCCGTCCGA
GGCGTGAACATGCGTCTAT -> GCGTGAACATGCGTCTATA
GGCTAAAGATCGATGCAAG -> GCTAAAGATCGATGCAAGC
GGCTAAATCTTGGATACAA -> GCTAAATCTTGGATACAAT
GGCTAAATCTTGGCCAATC -> GCTAAATCTTGGCCAATCG
GGCTAAATCTTGTCCGCAA -> GCTAAATCTTGTCCGCAAG
GGCTAAATCTTGTTGGTTC -> GCTAAATCTTGTTGGTTCC
GGCTGCCCTGTATAGGCAT -> GCTGCCCTGTATAGGCATG
GGCTGGCTAAATCTTGGAT -> GCTGGCTAAATCTTGGATA
GGCTGGCTAAATCTTGGCC -> GCTGGCTAAATCTTGGCCA
GGCTGGCTAAATCTTGTCC -> GCTGGCTAAATCTTGTCCG
GGCTGGCTAAATCTTGTTG -> GCTGGCTAAATCTTGTTGG
GGCTTATGCTCCCGGACCT -> GCTTATGCTCCCGGACCTC
GGCTTTTGTAGCAAGAAAT -> GCTTTTGTAGCAAGAAATA
GGGAACCCTGCACTATCAT -> GGAACCCTGCACTATCATC
GGGAATATCGGGTCAAAAC -> GGAATATCGGGTCAAAACT
GGGAATGTTGTGGTTCCCT -> GGAATGTTGTGGTTCCCTC
GGGACAGGTCAGTCAGTGG -> GGACAGGTCAGTCAGTGGA
GGGACGAACTTATACGATC -> GGACGAACTTATACGATCC
GGGACTAAGAGATCAGTTT -> GGACTAAGAGATCAGTTTG
GGGAGCACGGTCCGCGGAG -> GGAGCACGGTCCGCGGAGT
GGGAGGAATCGCAGACGCC -> GGAGGAATCGCAGACGCCC
GGGAGGATCTACACGCGTG -> GGAGGATCTACACGCGTGC
GGGAGGTGTCAGTCCTAGT -> GGAGGTGTCAGTCCTAGTA
GGGAGTACGCGCGTACAAC -> GGAGTACGCGCGTACAACT
GGGATCGTTACACTGATGA -> GGATCGTTACACTGATGAT
GGGATGGTGCTGGTCACAA -> GGATGGTGCTGGTCACAAA
GGGCAAACCATCGTTTAGG -> GGCAAACCATCGTTTAGGG
GGGCAAGGTCAAGGTCAAC -> GGCAAGGTCAAGGTCAACC
GGGCAGGCCGGGCAAACCA -> GGCAGGCCGGGCAAACCAT
GGGCCCATTGGTACGGTGA -> GGCCCATTGGTACGGTGAC
GGGGAACCCTGCACTATCA -> GGGAACCCTGCACTATCAT
GGGGATGGTGCTGGTCACA -> GGGATGGTGCTGGTCACAA
GGGGGATGGTGCTGGTCAC -> GGGGATGGTGCTGGTCACA
GGGGTGAAGGACCATCATC -> GGGTGAAGGACCATCATCA
GGGTCAAAACTAGTATCTT -> GGTCAAAACTAGTATCTTA
GGGTGAAGGACCATCATCA -> GGTGAAGGACCATCATCAG
GGGTGAATCCCATAAAAGA -> GGTGAATCCCATAAAAGAC
GGGTGACCCTTAAATATGT -> GGTGACCCTTAAATATGTA
GGGTGATGCTTTGCAGACA -> GGTGATGCTTTGCAGACAG
GGGTTAAACTATTTAACCG -> GGTTAAACTATTTAACCGG
GGTACACTGTGCCACTATT -> GTACACTGTGCCACTATTA
GGTACGGTGACTATTCTCA -> GTACGGTGACTATTCTCAC
GGTATGGAGCTGCAGGCAC -> GTATGGAGCTGCAGGCACA
GGTCAAAACTAGTATCTTA -> GTCAAAACTAGTATCTTAC
GGTCAACCGGGTGACCCTT -> GTCAACCGGGTGACCCTTA
GGTCAAGGTCAACCGGGTG -> GTCAAGGTCAACCGGGTGA
GGTCACAAAAATAGGAGCT -> GTCACAAAAATAGGAGCTA
GGTCAGTCAGTGGAAGCCT -> GTCAGTCAGTGGAAGCCTT
GGTCAGTGGCTGGCTAAAT -> GTCAGTGGCTGGCTAAATC
GGTCCCCGTCACAAGACCA -> GTCCCCGTCACAAGACCAA
GGTCCGCGGAGTAAGCGTG -> GTCCGCGGAGTAAGCGTGC
GGTCCGTAATTGCTCCAGG -> GTCCGTAATTGCTCCAGGC
GGTCGGGCAGGCCGGGCAA -> GTCGGGCAGGCCGGGCAAA
GGTCTCCATTTCGGTGATG -> GTCTCCATTTCGGTGATGC
GGTCTCTGTGGAGCTCCAC -> GTCTCTGTGGAGCTCCACC
GGTCTTCACCCCCCGAATA -> GTCTTCACCCCCCGAATAG
GGTGAAGGACCATCATCAG -> GTGAAGGACCATCATCAGG
GGTGAATCCCATAAAAGAC -> GTGAATCCCATAAAAGACT
GGTGACCCTTAAATATGTA -> GTGACCCTTAAATATGTAC
GGTGACTATTCTCACGGTC -> GTGACTATTCTCACGGTCT
GGTGATGCTCCAGGATCGA -> GTGATGCTCCAGGATCGAA
GGTGATGCTTTGCAGACAG -> GTGATGCTTTGCAGACAGA
GGTGCAGGAACGCCAAGGC -> GTGCAGGAACGCCAAGGCC
GGTGCCTATCAGCAGAGGG -> GTGCCTATCAGCAGAGGGA
GGTGCGATATCAGATATTT -> GTGCGATATCAGATATTTG
GGTGCTGGTCACAAAAATA -> GTGCTGGTCACAAAAATAG
GGTGTCAGTCCTAGTACGT -> GTGTCAGTCCTAGTACGTG
GGTGTGTCGGGTGATGCTT -> GTGTGTCGGGTGATGCTTT
GGTTAAACTATTTAACCGG -> GTTAAACTATTTAACCGGG
GGTTAAATGTCGCTTCTTG -> GTTAAATGTCGCTTCTTGC
GGTTCCCTCTTATCCCCGG -> GTTCCCTCTTATCCCCGGA
GGTTCCTGTCTCACTATGA -> GTTCCTGTCTCACTATGAA
GGTTGTGGATCATCATGCT -> GTTGTGGATCATCATGCTT
GGTTTTGCCCCAGGTCCGT -> GTTTTGCCCCAGGTCCGTA
GTAAAAAATCAAGACGCAG -> TAAAAAATCAAGACGCAGT
GTAACTCTGTGTGATGCAT -> TAACTCTGTGTGATGCATA
GTAAGCATTCGAGGATTCC -> TAAGCATTCGAGGATTCCC
GTAAGCGTGCTGACAGTGG -> TAAGCGTGCTGACAGTGGG
GTAATTGCTCCAGGCATTC -> TAATTGCTCCAGGCATTCC
GTACAACTTGTTCTACATT -> TACAACTTGTTCTACATTG
GTACACATGGAACTACGAA -> TACACATGGAACTACGAAC
GTACACTGTGCCACTATTA -> TACACTGTGCCACTATTAT
GTACGACGAGCTAACTAGC -> TACGACGAGCTAACTAGCC
GTACGATTGCGAACTTATA -> TACGATTGCGAACTTATAC
GTACGCGCGTACAACTTGT -> TACGCGCGTACAACTTGTT
GTACGGGCAAGGTCAAGGT -> TACGGGCAAGGTCAAGGTC
GTACGGTGACTATTCTCAC -> TACGGTGACTATTCTCACG
GTACGTGTAGTGTACGATT -> TACGTGTAGTGTACGATTG
GTACGTTATTGCCGTGTCG -> TACGTTATTGCCGTGTCGC
GTAGACACCCGACATCCAC -> TAGACACCCGACATCCACG
GTAGCAAGAAATAAATGCA -> TAGCAAGAAATAAATGCAG
GTAGCGTCTGTCCTGTGGT -> TAGCGTCTGTCCTGTGGTC
GTAGTATTGAATGAAAGGC -> TAGTATTGAATGAAAGGCC
GTAGTGGATGTCCTACCGG -> TAGTGGATGTCCTACCGGT
GTAGTGTACGATTGCGAAC -> TAGTGTACGATTGCGAACT
GTATAGGCATGTTATACCT -> TATAGGCATGTTATACCTA
GTATCCCCTGCTGCTCGCA -> TATCCCCTGCTGCTCGCAG
GTATCTGATAATCGTGGGA -> TATCTGATAATCGTGGGAA
GTATCTTACTTTCACCTTA -> TATCTTACTTTCACCTTAT
GTATGGAGCTGCAGGCACA -> TATGGAGCTGCAGGCACAG
GTATTGAATGAAAGGCCCC -> TATTGAATGAAAGGCCCCG
GTCAAAACTAGTATCTTAC -> TCAAAACTAGTATCTTACT
GTCAACCGGGTGACCCTTA -> TCAACCGGGTGACCCTTAA
GTCAAGGTCAACCGGGTGA -> TCAAGGTCAACCGGGTGAC
GTCACAAAAATAGGAGCTA -> TCACAAAAATAGGAGCTAT
GTCACAAGACCAATGGAGG -> TCACAAGACCAATGGAGGG
GTCACCCGAAGTAACTCTG -> TCACCCGAAGTAACTCTGT
GTCACTTCTCGGTTGTGGA -> TCACTTCTCGGTTGTGGAT
GTCAGGACACCCACAGTTA -> TCAGGACACCCACAGTTAC
GTCAGTCAGTGGAAGCCTT -> TCAGTCAGTGGAAGCCTTA
GTCAGTCCTAGTACGTGTA -> TCAGTCCTAGTACGTGTAG
GTCAGTGGAAGCCTTACTG -> TCAGTGGAAGCCTTACTGA
GTCAGTGGCTGGCTAAATC -> TCAGTGGCTGGCTAAATCT
GTCATGAGCACACTGCCAG -> TCATGAGCACACTGCCAGA
GTCATGCGGTATGGAGCTG -> TCATGCGGTATGGAGCTGC
GTCCAAGGGCCCATTGGTA -> TCCAAGGGCCCATTGGTAC
GTCCAATCGTCACTTCTCG -> TCCAATCGTCACTTCTCGG
GTCCCCGTCACAAGACCAA -> TCCCCGTCACAAGACCAAT
GTCCGAAATATCGATATGT -> TCCGAAATATCGATATGTA
GTCCGCAAGCTGATCGCAA -> TCCGCAAGCTGATCGCAAA
GTCCGCGGAGTAAGCGTGC -> TCCGCGGAGTAAGCGTGCT
GTCCGTAATTGCTCCAGGC -> TCCGTAATTGCTCCAGGCA
GTCCTAAAGGGTGAATCCC -> TCCTAAAGGGTGAATCCCA
GTCCTACCGGTCTCTGTGG -> TCCTACCGGTCTCTGTGGA
GTCCTAGTACGTGTAGTGT -> TCCTAGTACGTGTAGTGTA
GTCCTCGAACTTATACGAT -> TCCTCGAACTTATACGATC
GTCCTGTGACGGCAATCCT -> TCCTGTGACGGCAATCCTA
GTCCTGTGGTCTTCACCCC -> TCCTGTGGTCTTCACCCCC
GTCGAGGGAGTACGCGCGT -> TCGAGGGAGTACGCGCGTA
GTCGCCGGACGTCAGGACA -> TCGCCGGACGTCAGGACAC
GTCGCTTCTTGCCACTCCA -> TCGCTTCTTGCCACTCCAG
GTCGGGCAGGCCGGGCAAA -> TCGGGCAGGCCGGGCAAAC
GTCGGGTGATGCTTTGCAG -> TCGGGTGATGCTTTGCAGA
GTCGTAAAAAATCAAGACG -> TCGTAAAAAATCAAGACGC
GTCGTTAACGGTGCAGGAA -> TCGTTAACGGTGCAGGAAC
GTCTATAGTCCAATCGTCA -> TCTATAGTCCAATCGTCAC
GTCTCACTATGAACTGTGG -> TCTCACTATGAACTGTGGA
GTCTCACTTGGTCGGGCAG -> TCTCACTTGGTCGGGCAGG
GTCTCATTTGCGTACGGGC -> TCTCATTTGCGTACGGGCA
GTCTCCATTTCGGTGATGC -> TCTCCATTTCGGTGATGCT
GTCTCTGTGGAGCTCCACC -> TCTCTGTGGAGCTCCACCC
GTCTGCATATGTTAAACAC -> TCTGCATATGTTAAACACT
GTCTGTCCTGTGGTCTTCA -> TCTGTCCTGTGGTCTTCAC
GTCTTCACCCCCCGAATAG -> TCTTCACCCCCCGAATAGG
GTGAACATGCGTCTATAGT -> TGAACATGCGTCTATAGTC
GTGAAGGACCATCATCAGG -> TGAAGGACCATCATCAGGA
GTGAATCCCATAAAAGACT -> TGAATCCCATAAAAGACTT
GTGACCCTTAAATATGTAC -> TGACCCTTAAATATGTACG
GTGACGGCAATCCTAATCC -> TGACGGCAATCCTAATCCC
GTGACTATTAGTGGACGCT -> TGACTATTAGTGGACGCTT
GTGACTATTCTCACGGTCT -> TGACTATTCTCACGGTCTC
GTGAGATAACAGAGTCCAA -> TGAGATAACAGAGTCCAAG
GTGATATCTTAACGGCGCC -> TGATATCTTAACGGCGCCT
GTGATGCATAGCACTGGTA -> TGATGCATAGCACTGGTAC
GTGATGCCAGGTGCCTATC -> TGATGCCAGGTGCCTATCA
GTGATGCTCCAGGATCGAA -> TGATGCTCCAGGATCGAAT
GTGATGCTTTGCAGACAGA -> TGATGCTTTGCAGACAGAC
GTGATTTAAGTGGCTGGCT -> TGATTTAAGTGGCTGGCTA
GTGCAGGAACGCCAAGGCC -> TGCAGGAACGCCAAGGCCT
GTGCCACTATTATCCACTT -> TGCCACTATTATCCACTTG
GTGCCTATCAGCAGAGGGA -> TGCCTATCAGCAGAGGGAG
GTGCGAGGATGGCTTATGC -> TGCGAGGATGGCTTATGCT
GTGCGATATCAGATATTTG -> TGCGATATCAGATATTTGT
GTGCTCGGATGACATGTTG -> TGCTCGGATGACATGTTGA
GTGCTGACAGTGGGGTGAA -> TGCTGACAGTGGGGTGAAG
GTGCTGGTCACAAAAATAG -> TGCTGGTCACAAAAATAGG
GTGGAAGCCTTACTGACAG -> TGGAAGCCTTACTGACAGA
GTGGACGCTTTATTGTAGT -> TGGACGCTTTATTGTAGTG
GTGGAGCTCCACCCAGCTA -> TGGAGCTCCACCCAGCTAG
GTGGATCATCATGCTTCCC -> TGGATCATCATGCTTCCCA
GTGGATGTCCTACCGGTCT -> TGGATGTCCTACCGGTCTC
GTGGATTTAAGCTTTGACC -> TGGATTTAAGCTTTGACCC
GTGGCTGGCTAAATCTTGG -> TGGCTGGCTAAATCTTGGA,TGGCTGGCTAAATCTTGGC
GTGGCTGGCTAAATCTTGT -> TGGCTGGCTAAATCTTGTC,TGGCTGGCTAAATCTTGTT
GTGGGAATGTTGTGGTTCC -> TGGGAATGTTGTGGTTCCC
GTGGGGTGAAGGACCATCA -> TGGGGTGAAGGACCATCAT
GTGGTCTTCACCCCCCGAA -> TGGTCTTCACCCCCCGAAT
GTGGTTCCCTCTTATCCCC -> TGGTTCCCTCTTATCCCCG
GTGTACGATTGCGAACTTA -> TGTACGATTGCGAACTTAT
GTGTAGTGTACGATTGCGA -> TGTAGTGTACGATTGCGAA
GTGTCAGTCCTAGTACGTG -> TGTCAGTCCTAGTACGTGT
GTGTCGCCGGACGTCAGGA -> TGTCGCCGGACGTCAGGAC
GTGTCGGGTGATGCTTTGC -> TGTCGGGTGATGCTTTGCA
GTGTCTGCATATGTTAAAC -> TGTCTGCATATGTTAAACA
GTGTGATGCATAGCACTGG -> TGTGATGCATAGCACTGGT
GTGTGTCGGGTGATGCTTT -> TGTGTCGGGTGATGCTTTG
GTTAAACACTGTAAGCATT -> TTAAACACTGTAAGCATTC
GTTAAACTATTTAACCGGG -> TTAAACTATTTAACCGGGA
GTTAAATGTCGCTTCTTGC -> TTAAATGTCGCTTCTTGCC
GTTAACGGTGCAGGAACGC -> TTAACGGTGCAGGAACGCC
GTTACACTGATGATGATCG -> TTACACTGATGATGATCGC
GTTACCCCTAGGGACAGGT -> TTACCCCTAGGGACAGGTC
GTTATACCTACGGGGAACC -> TTATACCTACGGGGAACCC
GTTATTGCCGTGTCGCCGG -> TTATTGCCGTGTCGCCGGA
GTTCCCTCTTATCCCCGGA -> TTCCCTCTTATCCCCGGAA
GTTCCTGTCTCACTATGAA -> TTCCTGTCTCACTATGAAC
GTTCGATAATGAGCAACGA -> TTCGATAATGAGCAACGAG
GTTCTACATTGAACGGGAC -> TTCTACATTGAACGGGACG
GTTGAGTATCTGATAATCG -> TTGAGTATCTGATAATCGT
GTTGCATCACTTTCTGCCA -> TTGCATCACTTTCTGCCAG
GTTGGTTCCTGTCTCACTA -> TTGGTTCCTGTCTCACTAT
GTTGTGATTTAAGTGGCTG -> TTGTGATTTAAGTGGCTGG
GTTGTGGATCATCATGCTT -> TTGTGGATCATCATGCTTC
GTTGTGGTTCCCTCTTATC -> TTGTGGTTCCCTCTTATCC
GTTTAATTTTAAGGACATG -> TTTAATTTTAAGGACATGG
GTTTAGGGGGATGGTGCTG -> TTTAGGGGGATGGTGCTGG
GTTTCACGGCTTTTGTAGC -> TTTCACGGCTTTTGTAGCA
GTTTCGCCCTGAGCTATTC -> TTTCGCCCTGAGCTATTCA
GTTTGTCACCCGAAGTAAC -> TTTGTCACCCGAAGTAACT
GTTTTGCCCCAGGTCCGTA -> TTTTGCCCCAGGTCCGTAA
TAAAAAATCAAGACGCAGT -> AAAAAATCAAGACGCAGTT
TAAAAGACTTTGATGGTGT -> AAAAGACTTTGATGGTGTG
TAAACACTGTAAGCATTCG -> AAACACTGTAAGCATTCGA
TAAACTATTTAACCGGGAT -> AAACTATTTAACCGGGATC
TAAAGATCGATGCAAGCTA -> AAAGATCGATGCAAGCTAC
TAAAGGGTGAATCCCATAA -> AAAGGGTGAATCCCATAAA
TAAATATGTACGTTATTGC -> AAATATGTACGTTATTGCC
TAAATCTTGGATACAATAG -> AAATCTTGGATACAATAGG
TAAATCTTGGCCAATCGCC -> AAATCTTGGCCAATCGCCC
TAAATCTTGTCCGCAAGCT -> AAATCTTGTCCGCAAGCTG
TAAATCTTGTTGGTTCCTG -> AAATCTTGTTGGTTCCTGT
TAAATGCAGAGTAGCGTCT -> AAATGCAGAGTAGCGTCTG
TAAATGTCGCTTCTTGCCA -> AAATGTCGCTTCTTGCCAC
TAACAGAGTCCAAGGGCCC -> AACAGAGTCCAAGGGCCCA
TAACCGGGATCGTTACACT -> AACCGGGATCGTTACACTG
TAACGGCGCCTACTTGCCG -> AACGGCGCCTACTTGCCGT
TAACGGTGCAGGAACGCCA -> AACGGTGCAGGAACGCCAA
TAACTAGCCTGTCCTAAAG -> AACTAGCCTGTCCTAAAGG
TAACTCTGTGTGATGCATA -> AACTCTGTGTGATGCATAG
TAAGAGATCAGTTTGTCAC -> AAGAGATCAGTTTGTCACC
TAAGCATTCGAGGATTCCC -> AAGCATTCGAGGATTCCCC
TAAGCCATTTCCTCTCGTC -> AAGCCATTTCCTCTCGTCG
TAAGCGTGCTGACAGTGGG -> AAGCGTGCTGACAGTGGGG
TAAGCTTTGACCCCGTATC -> AAGCTTTGACCCCGTATCC
TAAGGACATGGAATCTTGG -> AAGGACATGGAATCTTGGC
TAAGGGAATATCGGGTCAA -> AAGGGAATATCGGGTCAAA
TAAGTGGCTGGCTAAATCT -> AAGTGGCTGGCTAAATCTT
TAATATCAGTGGCTGGCTA -> AATATCAGTGGCTGGCTAA
TAATCCCCACGGGAGGTGT -> AATCCCCACGGGAGGTGTC
TAATCGTGGGAATGTTGTG -> AATCGTGGGAATGTTGTGG
TAATGAGCAACGAGCTGTC -> AATGAGCAACGAGCTGTCG
TAATGAGTTTAATTTTAAG -> AATGAGTTTAATTTTAAGG
TAATGTCCTCGAACTTATA -> AATGTCCTCGAACTTATAC
TAATTGCTCCAGGCATTCC -> AATTGCTCCAGGCATTCCA
TAATTTTAAGGACATGGAA -> AATTTTAAGGACATGGAAT
TACAACTTGTTCTACATTG -> ACAACTTGTTCTACATTGA
TACAATAGGGAGGAATCGC -> ACAATAGGGAGGAATCGCA
TACACATGGAACTACGAAC -> ACACATGGAACTACGAACG
TACACGCGTGCGAGGATGG -> ACACGCGTGCGAGGATGGC
TACACTGATGATGATCGCT -> ACACTGATGATGATCGCTA
TACACTGTGCCACTATTAT -> ACACTGTGCCACTATTATC
TACACTTGGAGCAGTGATA -> ACACTTGGAGCAGTGATAT
TACATTGAACGGGACGAAC -> ACATTGAACGGGACGAACT
TACCCCTAGGGACAGGTCA -> ACCCCTAGGGACAGGTCAG
TACCGAGGGACTAAGAGAT -> ACCGAGGGACTAAGAGATC
TACCGGTCTCTGTGGAGCT -> ACCGGTCTCTGTGGAGCTC
TACCTACGGGGAACCCTGC -> ACCTACGGGGAACCCTGCA
TACGAAATTCTTTAATGTC -> ACGAAATTCTTTAATGTCC
TACGAACGTGCTCGGATGA -> ACGAACGTGCTCGGATGAC
TACGACGAGCTAACTAGCC -> ACGACGAGCTAACTAGCCT
TACGATCCCAATCATAATA -> ACGATCCCAATCATAATAT
TACGATCCCACACCTGCGG -> ACGATCCCACACCTGCGGT
TACGATCCCAGTTGTGATT -> ACGATCCCAGTTGTGATTT
TACGATCCCATTGGCAACC -> ACGATCCCATTGGCAACCA
TACGATCGGTTTTGCCCCA -> ACGATCGGTTTTGCCCCAG
TACGATTGCGAACTTATAC -> ACGATTGCGAACTTATACG
TACGCGCGTACAACTTGTT -> ACGCGCGTACAACTTGTTC
TACGCGTTGCATCACTTTC -> ACGCGTTGCATCACTTTCT
TACGGGCAAGGTCAAGGTC -> ACGGGCAAGGTCAAGGTCA
TACGGGGAACCCTGCACTA -> ACGGGGAACCCTGCACTAT
TACGGTGACTATTCTCACG -> ACGGTGACTATTCTCACGG
TACGTGTAGTGTACGATTG -> ACGTGTAGTGTACGATTGC
TACGTTATTGCCGTGTCGC -> ACGTTATTGCCGTGTCGCC
TACTCGACTGCGGCGTGAA -> ACTCGACTGCGGCGTGAAC
TACTGACAGAGAATCGCCG -> ACTGACAGAGAATCGCCGA
TACTTGAAGTCTCATTTGC -> ACTTGAAGTCTCATTTGCG
TACTTGCCGTCCGAAATAT -> ACTTGCCGTCCGAAATATC
TACTTTCACCTTATTTAAT -> ACTTTCACCTTATTTAATG
TAGACACCCGACATCCACG -> AGACACCCGACATCCACGC
TAGAGAGCCGAACTTATAC -> AGAGAGCCGAACTTATACG
TAGCAAGAAATAAATGCAG -> AGCAAGAAATAAATGCAGA
TAGCACTGGTACACTGTGC -> AGCACTGGTACACTGTGCC
TAGCCTGTCCTAAAGGGTG -> AGCCTGTCCTAAAGGGTGA
TAGCGCTAGTCATGCGGTA -> AGCGCTAGTCATGCGGTAT
TAGCGTCTGTCCTGTGGTC -> AGCGTCTGTCCTGTGGTCT
TAGGACTATTCGTCATGAG -> AGGACTATTCGTCATGAGC
TAGGAGCTATGTGAGATAA -> AGGAGCTATGTGAGATAAC
TAGGCATGTTATACCTACG -> AGGCATGTTATACCTACGG
TAGGGACAGGTCAGTCAGT -> AGGGACAGGTCAGTCAGTG
TAGGGAGGAATCGCAGACG -> AGGGAGGAATCGCAGACGC
TAGGGGGATGGTGCTGGTC -> AGGGGGATGGTGCTGGTCA
TAGTACGTGTAGTGTACGA -> AGTACGTGTAGTGTACGAT
TAGTATCTTACTTTCACCT -> AGTATCTTACTTTCACCTT
TAGTATTGAATGAAAGGCC -> AGTATTGAATGAAAGGCCC
TAGTCATGCGGTATGGAGC -> AGTCATGCGGTATGGAGCT
TAGTCCAATCGTCACTTCT -> AGTCCAATCGTCACTTCTC
TAGTCTCACTTGGTCGGGC -> AGTCTCACTTGGTCGGGCA
TAGTGGACGCTTTATTGTA -> AGTGGACGCTTTATTGTAG
TAGTGGATGTCCTACCGGT -> AGTGGATGTCCTACCGGTC
TAGTGTACGATTGCGAACT -> AGTGTACGATTGCGAACTT
TATACCTACGGGGAACCCT -> ATACCTACGGGGAACCCTG
TATACGATCCCAATCATAA -> ATACGATCCCAATCATAAT
TATACGATCCCACACCTGC -> ATACGATCCCACACCTGCG
TATACGATCCCAGTTGTGA -> ATACGATCCCAGTTGTGAT
TATACGATCCCATTGGCAA -> ATACGATCCCATTGGCAAC
TATAGGCATGTTATACCTA -> ATAGGCATGTTATACCTAC
TATAGTCCAATCGTCACTT -> ATAGTCCAATCGTCACTTC
TATCAGATATTTGTGATGC -> ATCAGATATTTGTGATGCC
TATCAGCAGAGGGAGGATC -> ATCAGCAGAGGGAGGATCT
TATCAGTGGCTGGCTAAAT -> ATCAGTGGCTGGCTAAATC
TATCATCCAGCCCGTCGTA -> ATCATCCAGCCCGTCGTAA
TATCCACAACAGCTGCACG -> ATCCACAACAGCTGCACGC
TATCCACTTGATGTTTCGC -> ATCCACTTGATGTTTCGCC
TATCCCCGGAATGATATGC -> ATCCCCGGAATGATATGCG
TATCCCCTGCTGCTCGCAG -> ATCCCCTGCTGCTCGCAGT
TATCGATATGTACACATGG -> ATCGATATGTACACATGGA
TATCGGGTCAAAACTAGTA -> ATCGGGTCAAAACTAGTAT
TATCGGTGCGATATCAGAT -> ATCGGTGCGATATCAGATA
TATCTGATAATCGTGGGAA -> ATCTGATAATCGTGGGAAT
TATCTTAACGGCGCCTACT -> ATCTTAACGGCGCCTACTT
TATCTTACTTTCACCTTAT -> ATCTTACTTTCACCTTATT
TATGAACTGTGGATTTAAG -> ATGAACTGTGGATTTAAGC
TATGCGTAGTATTGAATGA -> ATGCGTAGTATTGAATGAA
TATGCTCCCGGACCTCTCG -> ATGCTCCCGGACCTCTCGC
TATGGAGCTGCAGGCACAG -> ATGGAGCTGCAGGCACAGA
TATGTACACATGGAACTAC -> ATGTACACATGGAACTACG
TATGTACGTTATTGCCGTG -> ATGTACGTTATTGCCGTGT
TATGTGAGATAACAGAGTC -> ATGTGAGATAACAGAGTCC
TATGTTAAACACTGTAAGC -> ATGTTAAACACTGTAAGCA
TATTAGTGGACGCTTTATT -> ATTAGTGGACGCTTTATTG
TATTATCCACTTGATGTTT -> ATTATCCACTTGATGTTTC
TATTCAAGAGAGGCTGCCC -> ATTCAAGAGAGGCTGCCCT
TATTCGTCATGAGCACACT -> ATTCGTCATGAGCACACTG
TATTCTCACGGTCTCCATT -> ATTCTCACGGTCTCCATTT
TATTGAATGAAAGGCCCCG -> ATTGAATGAAAGGCCCCGT
TATTGCCGTGTCGCCGGAC -> ATTGCCGTGTCGCCGGACG
TATTGTAGTGGATGTCCTA -> ATTGTAGTGGATGTCCTAC
TATTTAACCGGGATCGTTA -> ATTTAACCGGGATCGTTAC
TATTTAATGAGTTTAATTT -> ATTTAATGAGTTTAATTTT
TATTTGTGATGCCAGGTGC -> ATTTGTGATGCCAGGTGCC
TCAAAACTAGTATCTTACT -> CAAAACTAGTATCTTACTT
TCAACCGGGTGACCCTTAA -> CAACCGGGTGACCCTTAAA
TCAAGACGCAGTTTCACGG -> CAAGACGCAGTTTCACGGC
TCAAGAGAGGCTGCCCTGT -> CAAGAGAGGCTGCCCTGTA
TCAAGGTCAACCGGGTGAC -> CAAGGTCAACCGGGTGACC
TCACAAAAATAGGAGCTAT -> CACAAAAATAGGAGCTATG
TCACAAGACCAATGGAGGG -> CACAAGACCAATGGAGGGT
TCACCCCCCGAATAGGACT -> CACCCCCCGAATAGGACTA
TCACCCGAAGTAACTCTGT -> CACCCGAAGTAACTCTGTG
TCACCTTATTTAATGAGTT -> CACCTTATTTAATGAGTTT
TCACGGCTTTTGTAGCAAG -> CACGGCTTTTGTAGCAAGA
TCACGGTCTCCATTTCGGT -> CACGGTCTCCATTTCGGTG
TCACTATGAACTGTGGATT -> CACTATGAACTGTGGATTT
TCACTTCTCGGTTGTGGAT -> CACTTCTCGGTTGTGGATC
TCACTTGGTCGGGCAGGCC -> CACTTGGTCGGGCAGGCCG
TCACTTTCTGCCAGCTTCC -> CACTTTCTGCCAGCTTCCA
TCAGATATTTGTGATGCCA -> CAGATATTTGTGATGCCAG
TCAGCAGAGGGAGGATCTA -> CAGCAGAGGGAGGATCTAC
TCAGGACACCCACAGTTAC -> CAGGACACCCACAGTTACC
TCAGGATTGCGTTCGATAA -> CAGGATTGCGTTCGATAAT
TCAGGTTAAATGTCGCTTC -> CAGGTTAAATGTCGCTTCT
TCAGTCAGTGGAAGCCTTA -> CAGTCAGTGGAAGCCTTAC
TCAGTCCTAGTACGTGTAG -> CAGTCCTAGTACGTGTAGT
TCAGTGGAAGCCTTACTGA -> CAGTGGAAGCCTTACTGAC
TCAGTGGCTGGCTAAATCT -> CAGTGGCTGGCTAAATCTT,CAGTGGCTGGCTAAATCTT
TCAGTTTGTCACCCGAAGT -> CAGTTTGTCACCCGAAGTA
TCATAATATCAGTGGCTGG -> CATAATATCAGTGGCTGGC
TCATCAGGATTGCGTTCGA -> CATCAGGATTGCGTTCGAT
TCATCATGCTTCCCATACC -> CATCATGCTTCCCATACCG
TCATCCAGCCCGTCGTAAA -> CATCCAGCCCGTCGTAAAA
TCATGAGCACACTGCCAGA -> CATGAGCACACTGCCAGAC
TCATGCGGTATGGAGCTGC -> CATGCGGTATGGAGCTGCA
TCATGCTTCCCATACCGAG -> CATGCTTCCCATACCGAGG
TCATTTGCGTACGGGCAAG -> CATTTGCGTACGGGCAAGG
TCCAAGGGCCCATTGGTAC -> CCAAGGGCCCATTGGTACG
TCCAATCGTCACTTCTCGG -> CCAATCGTCACTTCTCGGT
TCCACAACAGCTGCACGCC -> CCACAACAGCTGCACGCCG
TCCACAGGCGCACGGATAC -> CCACAGGCGCACGGATACT
TCCACCCAGCTAGTCTCAC -> CCACCCAGCTAGTCTCACT
TCCACGCACAAGAGGCCTG -> CCACGCACAAGAGGCCTGC
TCCACTTGATGTTTCGCCC -> CCACTTGATGTTTCGCCCT
TCCAGCCCGTCGTAAAAAA -> CCAGCCCGTCGTAAAAAAT
TCCAGGATCGAATCTGGAA -> CCAGGATCGAATCTGGAAC
TCCAGGCATTCCATTGAAC -> CCAGGCATTCCATTGAACA
TCCAGTGTCTGCATATGTT -> CCAGTGTCTGCATATGTTA
TCCATTGAACATGCCAATC -> CCATTGAACATGCCAATCT
TCCATTTCGGTGATGCTCC -> CCATTTCGGTGATGCTCCA
TCCCAATCATAATATCAGT -> CCCAATCATAATATCAGTG
TCCCACACCTGCGGTCAGT -> CCCACACCTGCGGTCAGTG
TCCCAGTTGTGATTTAAGT -> CCCAGTTGTGATTTAAGTG
TCCCATAAAAGACTTTGAT -> CCCATAAAAGACTTTGATG
TCCCATACCGAGGGACTAA -> CCCATACCGAGGGACTAAG
TCCCATTGGCAACCACAGT -> CCCATTGGCAACCACAGTG
TCCCCACGGGAGGTGTCAG -> CCCCACGGGAGGTGTCAGT
TCCCCCAGCAGTACGACGA -> CCCCCAGCAGTACGACGAG
TCCCCGGAATGATATGCGT -> CCCCGGAATGATATGCGTA
TCCCCGTCACAAGACCAAT -> CCCCGTCACAAGACCAATG
TCCCCTGCTGCTCGCAGTA -> CCCCTGCTGCTCGCAGTAG
TCCCGGACCTCTCGCTTCG -> CCCGGACCTCTCGCTTCGA
TCCCTCTTATCCCCGGAAT -> CCCTCTTATCCCCGGAATG
TCCGAAATATCGATATGTA -> CCGAAATATCGATATGTAC
TCCGCAAGCTGATCGCAAA -> CCGCAAGCTGATCGCAAAG
TCCGCGGAGTAAGCGTGCT -> CCGCGGAGTAAGCGTGCTG
TCCGTAATTGCTCCAGGCA -> CCGTAATTGCTCCAGGCAT
TCCTAAAGGGTGAATCCCA -> CCTAAAGGGTGAATCCCAT
TCCTAATCCCCACGGGAGG -> CCTAATCCCCACGGGAGGT
TCCTACCGGTCTCTGTGGA -> CCTACCGGTCTCTGTGGAG
TCCTAGCGCTAGTCATGCG -> CCTAGCGCTAGTCATGCGG
TCCTAGTACGTGTAGTGTA -> CCTAGTACGTGTAGTGTAC
TCCTCGAACTTATACGATC -> CCTCGAACTTATACGATCC
TCCTCTCGTCGTTAACGGT -> CCTCTCGTCGTTAACGGTG
TCCTGTCTCACTATGAACT -> CCTGTCTCACTATGAACTG
TCCTGTGACGGCAATCCTA -> CCTGTGACGGCAATCCTAA
TCCTGTGGTCTTCACCCCC -> CCTGTGGTCTTCACCCCCC
TCGAACTTATACGATCCCA -> CGAACTTATACGATCCCAT
TCGAATCTGGAACTCAGGG -> CGAATCTGGAACTCAGGGG
TCGACTGCGGCGTGAACAT -> CGACTGCGGCGTGAACATG
TCGAGGATTCCCCCAGCAG -> CGAGGATTCCCCCAGCAGT
TCGAGGGAGTACGCGCGTA -> CGAGGGAGTACGCGCGTAC
TCGATAATGAGCAACGAGC -> CGATAATGAGCAACGAGCT
TCGATATGTACACATGGAA -> CGATATGTACACATGGAAC
TCGATGCAAGCTACACTTG -> CGATGCAAGCTACACTTGG
TCGATTACGCGTTGCATCA -> CGATTACGCGTTGCATCAC
TCGCAAAGAGAGCCTCTAA -> CGCAAAGAGAGCCTCTAAG
TCGCAGACGCCCTACGATC -> CGCAGACGCCCTACGATCG
TCGCAGTAGACACCCGACA -> CGCAGTAGACACCCGACAT
TCGCCCTGAGCTATTCAAG -> CGCCCTGAGCTATTCAAGA
TCGCCCTTACTTGAAGTCT -> CGCCCTTACTTGAAGTCTC
TCGCCGAGACTTTTTAAGC -> CGCCGAGACTTTTTAAGCC
TCGCCGGACGTCAGGACAC -> CGCCGGACGTCAGGACACC
TCGCTAGAGAGCCGAACTT -> CGCTAGAGAGCCGAACTTA
TCGCTTCGATTACGCGTTG -> CGCTTCGATTACGCGTTGC
TCGCTTCTTGCCACTCCAG -> CGCTTCTTGCCACTCCAGT
TCGGATATCCACAACAGCT -> CGGATATCCACAACAGCTG
TCGGATGACATGTTGAGTA -> CGGATGACATGTTGAGTAT
TCGGGCAGGCCGGGCAAAC -> CGGGCAGGCCGGGCAAACC
TCGGGTCAAAACTAGTATC -> CGGGTCAAAACTAGTATCT
TCGGGTGATGCTTTGCAGA -> CGGGTGATGCTTTGCAGAC
TCGGTGATGCTCCAGGATC -> CGGTGATGCTCCAGGATCG
TCGGTGCGATATCAGATAT -> CGGTGCGATATCAGATATT
TCGGTTGTGGATCATCATG -> CGGTTGTGGATCATCATGC
TCGGTTTTGCCCCAGGTCC -> CGGTTTTGCCCCAGGTCCG
TCGTAAAAAATCAAGACGC -> CGTAAAAAATCAAGACGCA
TCGTCACTTCTCGGTTGTG -> CGTCACTTCTCGGTTGTGG
TCGTCATGAGCACACTGCC -> CGTCATGAGCACACTGCCA
TCGTCGTTAACGGTGCAGG -> CGTCGTTAACGGTGCAGGA
TCGTGGGAATGTTGTGGTT -> CGTGGGAATGTTGTGGTTC
TCGTTAACGGTGCAGGAAC -> CGTTAACGGTGCAGGAACG
TCGTTACACTGATGATGAT -> CGTTACACTGATGATGATC
TCGTTTAGGGGGATGGTGC -> CGTTTAGGGGGATGGTGCT
TCTAAGGGAATATCGGGTC -> CTAAGGGAATATCGGGTCA
TCTACACGCGTGCGAGGAT -> CTACACGCGTGCGAGGATG
TCTACATTGAACGGGACGA -> CTACATTGAACGGGACGAA
TCTATAGTCCAATCGTCAC -> CTATAGTCCAATCGTCACT
TCTCACGGTCTCCATTTCG -> CTCACGGTCTCCATTTCGG
TCTCACTATGAACTGTGGA -> CTCACTATGAACTGTGGAT
TCTCACTTGGTCGGGCAGG -> CTCACTTGGTCGGGCAGGC
TCTCATTTGCGTACGGGCA -> CTCATTTGCGTACGGGCAA
TCTCCATTTCGGTGATGCT -> CTCCATTTCGGTGATGCTC
TCTCCTAGCGCTAGTCATG -> CTCCTAGCGCTAGTCATGC
TCTCGCTTCGATTACGCGT -> CTCGCTTCGATTACGCGTT
TCTCGGTTGTGGATCATCA -> CTCGGTTGTGGATCATCAT
TCTCGTCGTTAACGGTGCA -> CTCGTCGTTAACGGTGCAG
TCTCTGTGGAGCTCCACCC -> CTCTGTGGAGCTCCACCCA
TCTGATAATCGTGGGAATG -> CTGATAATCGTGGGAATGT
TCTGCATATGTTAAACACT -> CTGCATATGTTAAACACTG
TCTGCCAGCTTCCACAGGC -> CTGCCAGCTTCCACAGGCG
TCTGTCCTGTGGTCTTCAC -> CTGTCCTGTGGTCTTCACC
TCTGTGGAGCTCCACCCAG -> CTGTGGAGCTCCACCCAGC
TCTGTGTGATGCATAGCAC -> CTGTGTGATGCATAGCACT
TCTTAACGGCGCCTACTTG -> CTTAACGGCGCCTACTTGC
TCTTACTTTCACCTTATTT -> CTTACTTTCACCTTATTTA
TCTTATCCCCGGAATGATA -> CTTATCCCCGGAATGATAT
TCTTCACCCCCCGAATAGG -> CTTCACCCCCCGAATAGGA
TCTTGCCACTCCAGTGTCT -> CTTGCCACTCCAGTGTCTG
TCTTGGATACAATAGGGAG -> CTTGGATACAATAGGGAGG
TCTTGGCCAATCGCCCTTA -> CTTGGCCAATCGCCCTTAC
TCTTGGCCCTATCGGTGCG -> CTTGGCCCTATCGGTGCGA
TCTTGTCCGCAAGCTGATC -> CTTGTCCGCAAGCTGATCG
TCTTGTTGGTTCCTGTCTC -> CTTGTTGGTTCCTGTCTCA
TCTTTAATGTCCTCGAACT -> CTTTAATGTCCTCGAACTT
TGAAAGGCCCCGTCCTGTG -> GAAAGGCCCCGTCCTGTGA
TGAACATGCCAATCTCCTA -> GAACATGCCAATCTCCTAG
TGAACATGCGTCTATAGTC -> GAACATGCGTCTATAGTCC
TGAACGGGACGAACTTATA -> GAACGGGACGAACTTATAC
TGAACTGTGGATTTAAGCT -> GAACTGTGGATTTAAGCTT
TGAAGGACCATCATCAGGA -> GAAGGACCATCATCAGGAT
TGAAGTCTCATTTGCGTAC -> GAAGTCTCATTTGCGTACG
TGAATCCCATAAAAGACTT -> GAATCCCATAAAAGACTTT
TGAATGAAAGGCCCCGTCC -> GAATGAAAGGCCCCGTCCT
TGACAGAGAATCGCCGAGA -> GACAGAGAATCGCCGAGAC
TGACAGTGGGGTGAAGGAC -> GACAGTGGGGTGAAGGACC
TGACATGTTGAGTATCTGA -> GACATGTTGAGTATCTGAT
TGACCCCGTATCCCCTGCT -> GACCCCGTATCCCCTGCTG
TGACCCTTAAATATGTACG -> GACCCTTAAATATGTACGT
TGACGGCAATCCTAATCCC -> GACGGCAATCCTAATCCCC
TGACTATTAGTGGACGCTT -> GACTATTAGTGGACGCTTT
TGACTATTCTCACGGTCTC -> GACTATTCTCACGGTCTCC
TGAGATAACAGAGTCCAAG -> GAGATAACAGAGTCCAAGG
TGAGCAACGAGCTGTCGAG -> GAGCAACGAGCTGTCGAGG
TGAGCACACTGCCAGACAC -> GAGCACACTGCCAGACACC
TGAGCTATTCAAGAGAGGC -> GAGCTATTCAAGAGAGGCT
TGAGTATCTGATAATCGTG -> GAGTATCTGATAATCGTGG
TGAGTTTAATTTTAAGGAC -> GAGTTTAATTTTAAGGACA
TGATAATCGTGGGAATGTT -> GATAATCGTGGGAATGTTG
TGATATCTTAACGGCGCCT -> GATATCTTAACGGCGCCTA
TGATATGCGTAGTATTGAA -> GATATGCGTAGTATTGAAT
TGATCGCAAAGAGAGCCTC -> GATCGCAAAGAGAGCCTCT
TGATCGCTAGAGAGCCGAA -> GATCGCTAGAGAGCCGAAC
TGATGATCGCTAGAGAGCC -> GATGATCGCTAGAGAGCCG
TGATGATGATCGCTAGAGA -> GATGATGATCGCTAGAGAG
TGATGCATAGCACTGGTAC -> GATGCATAGCACTGGTACA
TGATGCCAGGTGCCTATCA -> GATGCCAGGTGCCTATCAG
TGATGCTCCAGGATCGAAT -> GATGCTCCAGGATCGAATC
TGATGCTTTGCAGACAGAC -> GATGCTTTGCAGACAGACC
TGATGGTGTGTCGGGTGAT -> GATGGTGTGTCGGGTGATG
TGATGTTTCGCCCTGAGCT -> GATGTTTCGCCCTGAGCTA
TGATTTAAGTGGCTGGCTA -> GATTTAAGTGGCTGGCTAA
TGCAAGCTACACTTGGAGC -> GCAAGCTACACTTGGAGCA
TGCACGCCGTGACTATTAG -> GCACGCCGTGACTATTAGT
TGCACTATCATCCAGCCCG -> GCACTATCATCCAGCCCGT
TGCAGACAGACCAATGGGA -> GCAGACAGACCAATGGGAG
TGCAGAGTAGCGTCTGTCC -> GCAGAGTAGCGTCTGTCCT
TGCAGGAACGCCAAGGCCT -> GCAGGAACGCCAAGGCCTA
TGCAGGCACAGAAAACCCC -> GCAGGCACAGAAAACCCCG
TGCATAGCACTGGTACACT -> GCATAGCACTGGTACACTG
TGCATATGTTAAACACTGT -> GCATATGTTAAACACTGTA
TGCATCACTTTCTGCCAGC -> GCATCACTTTCTGCCAGCT
TGCCAATCTCCTAGCGCTA -> GCCAATCTCCTAGCGCTAG
TGCCACTATTATCCACTTG -> GCCACTATTATCCACTTGA
TGCCACTCCAGTGTCTGCA -> GCCACTCCAGTGTCTGCAT
TGCCAGACACCCTCAGGTT -> GCCAGACACCCTCAGGTTA
TGCCAGCTTCCACAGGCGC -> GCCAGCTTCCACAGGCGCA
TGCCAGGTGCCTATCAGCA -> GCCAGGTGCCTATCAGCAG
TGCCCCAGGTCCGTAATTG -> GCCCCAGGTCCGTAATTGC
TGCCCTGTATAGGCATGTT -> GCCCTGTATAGGCATGTTA
TGCCGTCCGAAATATCGAT -> GCCGTCCGAAATATCGATA
TGCCGTGTCGCCGGACGTC -> GCCGTGTCGCCGGACGTCA
TGCCTATCAGCAGAGGGAG -> GCCTATCAGCAGAGGGAGG
TGCGAACTTATACGATCCC -> GCGAACTTATACGATCCCA
TGCGAGGATGGCTTATGCT -> GCGAGGATGGCTTATGCTC
TGCGATATCAGATATTTGT -> GCGATATCAGATATTTGTG
TGCGGCGTGAACATGCGTC -> GCGGCGTGAACATGCGTCT
TGCGGCTAAAGATCGATGC -> GCGGCTAAAGATCGATGCA
TGCGGTATGGAGCTGCAGG -> GCGGTATGGAGCTGCAGGC
TGCGGTCAGTGGCTGGCTA -> GCGGTCAGTGGCTGGCTAA
TGCGTACGGGCAAGGTCAA -> GCGTACGGGCAAGGTCAAG
TGCGTAGTATTGAATGAAA -> GCGTAGTATTGAATGAAAG
TGCGTCTATAGTCCAATCG -> GCGTCTATAGTCCAATCGT
TGCGTTCGATAATGAGCAA -> GCGTTCGATAATGAGCAAC
TGCTCCAGGATCGAATCTG -> GCTCCAGGATCGAATCTGG
TGCTCCAGGCATTCCATTG -> GCTCCAGGCATTCCATTGA
TGCTCCCGGACCTCTCGCT -> GCTCCCGGACCTCTCGCTT
TGCTCGCAGTAGACACCCG -> GCTCGCAGTAGACACCCGA
TGCTCGGATGACATGTTGA -> GCTCGGATGACATGTTGAG
TGCTGACAGTGGGGTGAAG -> GCTGACAGTGGGGTGAAGG
TGCTGCTCGCAGTAGACAC -> GCTGCTCGCAGTAGACACC
TGCTGGTCACAAAAATAGG -> GCTGGTCACAAAAATAGGA
TGCTTCCCATACCGAGGGA -> GCTTCCCATACCGAGGGAC
TGCTTTGCAGACAGACCAA -> GCTTTGCAGACAGACCAAT
TGGAACTACGAACGTGCTC -> GGAACTACGAACGTGCTCG
TGGAAGCCTTACTGACAGA -> GGAAGCCTTACTGACAGAG
TGGAATCTTGGCCCTATCG -> GGAATCTTGGCCCTATCGG
TGGACGCTTTATTGTAGTG -> GGACGCTTTATTGTAGTGG
TGGAGCAGTGATATCTTAA -> GGAGCAGTGATATCTTAAC
TGGAGCTCCACCCAGCTAG -> GGAGCTCCACCCAGCTAGT
TGGAGCTGCAGGCACAGAA -> GGAGCTGCAGGCACAGAAA
TGGAGGGTTAAACTATTTA -> GGAGGGTTAAACTATTTAA
TGGATACAATAGGGAGGAA -> GGATACAATAGGGAGGAAT
TGGATCATCATGCTTCCCA -> GGATCATCATGCTTCCCAT
TGGATGTCCTACCGGTCTC -> GGATGTCCTACCGGTCTCT
TGGATTTAAGCTTTGACCC -> GGATTTAAGCTTTGACCCC
TGGCAACCACAGTGGCTGG -> GGCAACCACAGTGGCTGGC
TGGCCAATCGCCCTTACTT -> GGCCAATCGCCCTTACTTG
TGGCCCTATCGGTGCGATA -> GGCCCTATCGGTGCGATAT
TGGCTAAATCTTGGATACA -> GGCTAAATCTTGGATACAA
TGGCTAAATCTTGGCCAAT -> GGCTAAATCTTGGCCAATC
TGGCTAAATCTTGTCCGCA -> GGCTAAATCTTGTCCGCAA
TGGCTAAATCTTGTTGGTT -> GGCTAAATCTTGTTGGTTC
TGGCTGGCTAAATCTTGGA -> GGCTGGCTAAATCTTGGAT
TGGCTGGCTAAATCTTGGC -> GGCTGGCTAAATCTTGGCC
TGGCTGGCTAAATCTTGTC -> GGCTGGCTAAATCTTGTCC
TGGCTGGCTAAATCTTGTT -> GGCTGGCTAAATCTTGTTG
TGGCTTATGCTCCCGGACC -> GGCTTATGCTCCCGGACCT
TGGGAATGTTGTGGTTCCC -> GGGAATGTTGTGGTTCCCT
TGGGAGCACGGTCCGCGGA -> GGGAGCACGGTCCGCGGAG
TGGGGTGAAGGACCATCAT -> GGGGTGAAGGACCATCATC
TGGTACACTGTGCCACTAT -> GGTACACTGTGCCACTATT
TGGTACGGTGACTATTCTC -> GGTACGGTGACTATTCTCA
TGGTCACAAAAATAGGAGC -> GGTCACAAAAATAGGAGCT
TGGTCCCCGTCACAAGACC -> GGTCCCCGTCACAAGACCA
TGGTCGGGCAGGCCGGGCA -> GGTCGGGCAGGCCGGGCAA
TGGTCTTCACCCCCCGAAT -> GGTCTTCACCCCCCGAATA
TGGTGCTGGTCACAAAAAT -> GGTGCTGGTCACAAAAATA
TGGTGTGTCGGGTGATGCT -> GGTGTGTCGGGTGATGCTT
TGGTTCCCTCTTATCCCCG -> GGTTCCCTCTTATCCCCGG
TGGTTCCTGTCTCACTATG -> GGTTCCTGTCTCACTATGA
TGTAAGCATTCGAGGATTC -> GTAAGCATTCGAGGATTCC
TGTACACATGGAACTACGA -> GTACACATGGAACTACGAA
TGTACGATTGCGAACTTAT -> GTACGATTGCGAACTTATA
TGTACGTTATTGCCGTGTC -> GTACGTTATTGCCGTGTCG
TGTAGCAAGAAATAAATGC -> GTAGCAAGAAATAAATGCA
TGTAGTGGATGTCCTACCG -> GTAGTGGATGTCCTACCGG
TGTAGTGTACGATTGCGAA -> GTAGTGTACGATTGCGAAC
TGTATAGGCATGTTATACC -> GTATAGGCATGTTATACCT
TGTCACCCGAAGTAACTCT -> GTCACCCGAAGTAACTCTG
TGTCAGTCCTAGTACGTGT -> GTCAGTCCTAGTACGTGTA
TGTCCGCAAGCTGATCGCA -> GTCCGCAAGCTGATCGCAA
TGTCCTAAAGGGTGAATCC -> GTCCTAAAGGGTGAATCCC
TGTCCTACCGGTCTCTGTG -> GTCCTACCGGTCTCTGTGG
TGTCCTCGAACTTATACGA -> GTCCTCGAACTTATACGAT
TGTCCTGTGGTCTTCACCC -> GTCCTGTGGTCTTCACCCC
TGTCGAGGGAGTACGCGCG -> GTCGAGGGAGTACGCGCGT
TGTCGCCGGACGTCAGGAC -> GTCGCCGGACGTCAGGACA
TGTCGCTTCTTGCCACTCC -> GTCGCTTCTTGCCACTCCA
TGTCGGGTGATGCTTTGCA -> GTCGGGTGATGCTTTGCAG
TGTCTCACTATGAACTGTG -> GTCTCACTATGAACTGTGG
TGTCTGCATATGTTAAACA -> GTCTGCATATGTTAAACAC
TGTGACGGCAATCCTAATC -> GTGACGGCAATCCTAATCC
TGTGAGATAACAGAGTCCA -> GTGAGATAACAGAGTCCAA
TGTGATGCATAGCACTGGT -> GTGATGCATAGCACTGGTA
TGTGATGCCAGGTGCCTAT -> GTGATGCCAGGTGCCTATC
TGTGATTTAAGTGGCTGGC -> GTGATTTAAGTGGCTGGCT
TGTGCCACTATTATCCACT -> GTGCCACTATTATCCACTT
TGTGGAGCTCCACCCAGCT -> GTGGAGCTCCACCCAGCTA
TGTGGATCATCATGCTTCC -> GTGGATCATCATGCTTCCC
TGTGGATTTAAGCTTTGAC -> GTGGATTTAAGCTTTGACC
TGTGGTCTTCACCCCCCGA -> GTGGTCTTCACCCCCCGAA
TGTGGTTCCCTCTTATCCC -> GTGGTTCCCTCTTATCCCC
TGTGTCGGGTGATGCTTTG -> GTGTCGGGTGATGCTTTGC
TGTGTGATGCATAGCACTG -> GTGTGATGCATAGCACTGG
TGTTAAACACTGTAAGCAT -> GTTAAACACTGTAAGCATT
TGTTATACCTACGGGGAAC -> GTTATACCTACGGGGAACC
TGTTCTACATTGAACGGGA -> GTTCTACATTGAACGGGAC
TGTTGAGTATCTGATAATC -> GTTGAGTATCTGATAATCG
TGTTGGTTCCTGTCTCACT -> GTTGGTTCCTGTCTCACTA
TGTTGTGGTTCCCTCTTAT -> GTTGTGGTTCCCTCTTATC
TGTTTCGCCCTGAGCTATT -> GTTTCGCCCTGAGCTATTC
TTAAACACTGTAAGCATTC -> TAAACACTGTAAGCATTCG
TTAAACTATTTAACCGGGA -> TAAACTATTTAACCGGGAT
TTAAATATGTACGTTATTG -> TAAATATGTACGTTATTGC
TTAAATGTCGCTTCTTGCC -> TAAATGTCGCTTCTTGCCA
TTAACCGGGATCGTTACAC -> TAACCGGGATCGTTACACT
TTAACGGCGCCTACTTGCC -> TAACGGCGCCTACTTGCCG
TTAACGGTGCAGGAACGCC -> TAACGGTGCAGGAACGCCA
TTAAGCCATTTCCTCTCGT -> TAAGCCATTTCCTCTCGTC
TTAAGCTTTGACCCCGTAT -> TAAGCTTTGACCCCGTATC
TTAAGGACATGGAATCTTG -> TAAGGACATGGAATCTTGG
TTAAGTGGCTGGCTAAATC -> TAAGTGGCTGGCTAAATCT
TTAATGAGTTTAATTTTAA -> TAATGAGTTTAATTTTAAG
TTAATGTCCTCGAACTTAT -> TAATGTCCTCGAACTTATA
TTAATTTTAAGGACATGGA -> TAATTTTAAGGACATGGAA
TTACACTGATGATGATCGC -> TACACTGATGATGATCGCT
TTACCCCTAGGGACAGGTC -> TACCCCTAGGGACAGGTCA
TTACGCGTTGCATCACTTT -> TACGCGTTGCATCACTTTC
TTACTGACAGAGAATCGCC -> TACTGACAGAGAATCGCCG
TTACTTGAAGTCTCATTTG -> TACTTGAAGTCTCATTTGC
TTACTTTCACCTTATTTAA -> TACTTTCACCTTATTTAAT
TTAGGGGGATGGTGCTGGT -> TAGGGGGATGGTGCTGGTC
TTAGTGGACGCTTTATTGT -> TAGTGGACGCTTTATTGTA
TTATACCTACGGGGAACCC -> TATACCTACGGGGAACCCT
TTATACGATCCCAATCATA -> TATACGATCCCAATCATAA
TTATACGATCCCACACCTG -> TATACGATCCCACACCTGC
TTATACGATCCCAGTTGTG -> TATACGATCCCAGTTGTGA
TTATACGATCCCATTGGCA -> TATACGATCCCATTGGCAA
TTATCCACTTGATGTTTCG -> TATCCACTTGATGTTTCGC
TTATCCCCGGAATGATATG -> TATCCCCGGAATGATATGC
TTATGCTCCCGGACCTCTC -> TATGCTCCCGGACCTCTCG
TTATTGCCGTGTCGCCGGA -> TATTGCCGTGTCGCCGGAC
TTATTGTAGTGGATGTCCT -> TATTGTAGTGGATGTCCTA
TTATTTAATGAGTTTAATT -> TATTTAATGAGTTTAATTT
TTCAAGAGAGGCTGCCCTG -> TCAAGAGAGGCTGCCCTGT
TTCACCCCCCGAATAGGAC -> TCACCCCCCGAATAGGACT
TTCACCTTATTTAATGAGT -> TCACCTTATTTAATGAGTT
TTCACGGCTTTTGTAGCAA -> TCACGGCTTTTGTAGCAAG
TTCCACAGGCGCACGGATA -> TCCACAGGCGCACGGATAC
TTCCATTGAACATGCCAAT -> TCCATTGAACATGCCAATC
TTCCCATACCGAGGGACTA -> TCCCATACCGAGGGACTAA
TTCCCCCAGCAGTACGACG -> TCCCCCAGCAGTACGACGA
TTCCCTCTTATCCCCGGAA -> TCCCTCTTATCCCCGGAAT
TTCCTCTCGTCGTTAACGG -> TCCTCTCGTCGTTAACGGT
TTCCTGTCTCACTATGAAC -> TCCTGTCTCACTATGAACT
TTCGAGGATTCCCCCAGCA -> TCGAGGATTCCCCCAGCAG
TTCGATAATGAGCAACGAG -> TCGATAATGAGCAACGAGC
TTCGATTACGCGTTGCATC -> TCGATTACGCGTTGCATCA
TTCGCCCTGAGCTATTCAA -> TCGCCCTGAGCTATTCAAG
TTCGGATATCCACAACAGC -> TCGGATATCCACAACAGCT
TTCGGTGATGCTCCAGGAT -> TCGGTGATGCTCCAGGATC
TTCGTCATGAGCACACTGC -> TCGTCATGAGCACACTGCC
TTCTACATTGAACGGGACG -> TCTACATTGAACGGGACGA
TTCTCACGGTCTCCATTTC -> TCTCACGGTCTCCATTTCG
TTCTCGGTTGTGGATCATC -> TCTCGGTTGTGGATCATCA
TTCTGCCAGCTTCCACAGG -> TCTGCCAGCTTCCACAGGC
TTCTTGCCACTCCAGTGTC -> TCTTGCCACTCCAGTGTCT
TTCTTTAATGTCCTCGAAC -> TCTTTAATGTCCTCGAACT
TTGAACATGCCAATCTCCT -> TGAACATGCCAATCTCCTA
TTGAACGGGACGAACTTAT -> TGAACGGGACGAACTTATA
TTGAAGTCTCATTTGCGTA -> TGAAGTCTCATTTGCGTAC
TTGAATGAAAGGCCCCGTC -> TGAATGAAAGGCCCCGTCC
TTGACCCCGTATCCCCTGC -> TGACCCCGTATCCCCTGCT
TTGAGTATCTGATAATCGT -> TGAGTATCTGATAATCGTG
TTGATGGTGTGTCGGGTGA -> TGATGGTGTGTCGGGTGAT
TTGATGTTTCGCCCTGAGC -> TGATGTTTCGCCCTGAGCT
TTGCAGACAGACCAATGGG -> TGCAGACAGACCAATGGGA
TTGCATCACTTTCTGCCAG -> TGCATCACTTTCTGCCAGC
TTGCCACTCCAGTGTCTGC -> TGCCACTCCAGTGTCTGCA
TTGCCCCAGGTCCGTAATT -> TGCCCCAGGTCCGTAATTG
TTGCCGTCCGAAATATCGA -> TGCCGTCCGAAATATCGAT
TTGCCGTGTCGCCGGACGT -> TGCCGTGTCGCCGGACGTC
TTGCGAACTTATACGATCC -> TGCGAACTTATACGATCCC
TTGCGTACGGGCAAGGTCA -> TGCGTACGGGCAAGGTCAA
TTGCGTTCGATAATGAGCA -> TGCGTTCGATAATGAGCAA
TTGCTCCAGGCATTCCATT -> TGCTCCAGGCATTCCATTG
TTGGAGCAGTGATATCTTA -> TGGAGCAGTGATATCTTAA
TTGGATACAATAGGGAGGA -> TGGATACAATAGGGAGGAA
TTGGCAACCACAGTGGCTG -> TGGCAACCACAGTGGCTGG
TTGGCCAATCGCCCTTACT -> TGGCCAATCGCCCTTACTT
TTGGCCCTATCGGTGCGAT -> TGGCCCTATCGGTGCGATA
TTGGTACGGTGACTATTCT -> TGGTACGGTGACTATTCTC
TTGGTCGGGCAGGCCGGGC -> TGGTCGGGCAGGCCGGGCA
TTGGTTCCTGTCTCACTAT -> TGGTTCCTGTCTCACTATG
TTGTAGCAAGAAATAAATG -> TGTAGCAAGAAATAAATGC
TTGTAGTGGATGTCCTACC -> TGTAGTGGATGTCCTACCG
TTGTCACCCGAAGTAACTC -> TGTCACCCGAAGTAACTCT
TTGTCCGCAAGCTGATCGC -> TGTCCGCAAGCTGATCGCA
TTGTGATGCCAGGTGCCTA -> TGTGATGCCAGGTGCCTAT
TTGTGATTTAAGTGGCTGG -> TGTGATTTAAGTGGCTGGC
TTGTGGATCATCATGCTTC -> TGTGGATCATCATGCTTCC
TTGTGGTTCCCTCTTATCC -> TGTGGTTCCCTCTTATCCC
TTGTTCTACATTGAACGGG -> TGTTCTACATTGAACGGGA
TTGTTGGTTCCTGTCTCAC -> TGTTGGTTCCTGTCTCACT
TTTAACCGGGATCGTTACA -> TTAACCGGGATCGTTACAC
TTTAAGCCATTTCCTCTCG -> TTAAGCCATTTCCTCTCGT
TTTAAGCTTTGACCCCGTA -> TTAAGCTTTGACCCCGTAT
TTTAAGGACATGGAATCTT -> TTAAGGACATGGAATCTTG
TTTAAGTGGCTGGCTAAAT -> TTAAGTGGCTGGCTAAATC
TTTAATGAGTTTAATTTTA -> TTAATGAGTTTAATTTTAA
TTTAATGTCCTCGAACTTA -> TTAATGTCCTCGAACTTAT
TTTAATTTTAAGGACATGG -> TTAATTTTAAGGACATGGA
TTTAGGGGGATGGTGCTGG -> TTAGGGGGATGGTGCTGGT
TTTATTGTAGTGGATGTCC -> TTATTGTAGTGGATGTCCT
TTTCACCTTATTTAATGAG -> TTCACCTTATTTAATGAGT
TTTCACGGCTTTTGTAGCA -> TTCACGGCTTTTGTAGCAA
TTTCCTCTCGTCGTTAACG -> TTCCTCTCGTCGTTAACGG
TTTCGCCCTGAGCTATTCA -> TTCGCCCTGAGCTATTCAA
TTTCGGATATCCACAACAG -> TTCGGATATCCACAACAGC
TTTCGGTGATGCTCCAGGA -> TTCGGTGATGCTCCAGGAT
TTTCTGCCAGCTTCCACAG -> TTCTGCCAGCTTCCACAGG
TTTGACCCCGTATCCCCTG -> TTGACCCCGTATCCCCTGC
TTTGATGGTGTGTCGGGTG -> TTGATGGTGTGTCGGGTGA
TTTGCAGACAGACCAATGG -> TTGCAGACAGACCAATGGG
TTTGCCCCAGGTCCGTAAT -> TTGCCCCAGGTCCGTAATT
TTTGCGTACGGGCAAGGTC -> TTGCGTACGGGCAAGGTCA
TTTGTAGCAAGAAATAAAT -> TTGTAGCAAGAAATAAATG
TTTGTCACCCGAAGTAACT -> TTGTCACCCGAAGTAACTC
TTTGTGATGCCAGGTGCCT -> TTGTGATGCCAGGTGCCTA
TTTTAAGCCATTTCCTCTC -> TTTAAGCCATTTCCTCTCG
TTTTAAGGACATGGAATCT -> TTTAAGGACATGGAATCTT
TTTTGCCCCAGGTCCGTAA -> TTTGCCCCAGGTCCGTAAT
TTTTGTAGCAAGAAATAAA -> TTTGTAGCAAGAAATAAAT
TTTTTAAGCCATTTCCTCT -> TTTTAAGCCATTTCCTCTC
